Rank,Release Group,Worldwide,Domestic,Foreign,filename,year,Domestic %,Foreign %
1,Avengers: Endgame,2797501328,858373000,1939128328,2019.csv,2019,30.683560054417246,69.31643994558276
2,Star Wars: Episode VII - The Force Awakens,2068223624,936662225,1131561399,2015.csv,2015,45.28824707980417,54.711752920195835
3,Avengers: Infinity War,2048359754,678815482,1369544272,2018.csv,2018,33.13946589091205,66.86053410908795
4,Jurassic World,1670400637,652270625,1018130012,2015.csv,2015,39.04875336802209,60.95124663197791
5,The Lion King,1656943394,543638043,1113305351,2019.csv,2019,32.809693135479556,67.19030686452044
6,The Avengers,1518812988,623357910,895455078,2012.csv,2012,41.04244004529147,58.95755995470853
7,Furious 7,1515047671,353007020,1162040651,2015.csv,2015,23.30006023949064,76.69993976050937
8,Frozen II,1450026933,477373578,972653355,2019.csv,2019,32.9217042205105,67.0782957794895
9,Avengers: Age of Ultron,1402805868,459005868,943800000,2015.csv,2015,32.72055517235689,67.2794448276431
10,Black Panther,1346913161,700059566,646853595,2018.csv,2018,51.97510769589992,48.02489230410007
11,Harry Potter and the Deathly Hallows: Part 2,1341511219,381011219,960500000,2011.csv,2011,28.40164238686102,71.59835761313897
12,Star Wars: Episode VIII - The Last Jedi,1332539889,620181382,712358507,2017.csv,2017,46.5412995978239,53.458700402176106
13,Jurassic World: Fallen Kingdom,1308467944,417719760,890748184,2018.csv,2018,31.924340364275672,68.07565963572432
14,Frozen,1280802282,400738009,880064273,2013.csv,2013,31.288046143565506,68.71195385643449
15,Beauty and the Beast,1263521126,504014165,759506961,2017.csv,2017,39.88965080430321,60.11034919569679
16,Incredibles 2,1242805359,608581744,634223615,2018.csv,2018,48.9683874946986,51.0316125053014
17,The Fate of the Furious,1236005118,226008385,1009996733,2017.csv,2017,18.28539232634472,81.71460767365528
18,Iron Man 3,1214811252,409013994,805797258,2013.csv,2013,33.668933616363965,66.33106638363603
19,Minions,1159398397,336045770,823352627,2015.csv,2015,28.984494964762312,71.01550503523768
20,Captain America: Civil War,1153296293,408084349,745211944,2016.csv,2016,35.384172434862755,64.61582756513724
21,Aquaman,1148461807,335061807,813400000,2018.csv,2018,29.174832367760228,70.82516763223977
22,Spider-Man: Far from Home,1131927996,390532085,741395911,2019.csv,2019,34.5014953583673,65.4985046416327
23,Captain Marvel,1128274794,426829839,701444955,2019.csv,2019,37.83030882811692,62.16969117188308
24,Transformers: Dark of the Moon,1123794079,352390543,771403536,2011.csv,2011,31.357216556397248,68.64278344360275
25,Skyfall,1108561013,304360277,804200736,2012.csv,2012,27.45543758356943,72.54456241643057
26,Transformers: Age of Extinction,1104054072,245439076,858614996,2014.csv,2014,22.230711540729683,77.76928845927031
27,The Dark Knight Rises,1081041287,448139099,632902188,2012.csv,2012,41.45439257399981,58.54560742600019
28,Joker,1074251311,335451311,738800000,2019.csv,2019,31.22652097931673,68.77347902068327
29,Star Wars: Episode IX - The Rise of Skywalker,1074144248,515202542,558941706,2019.csv,2019,47.963999524205434,52.03600047579457
30,Toy Story 4,1073394593,434038008,639356585,2019.csv,2019,40.436015872496576,59.563984127503424
31,Rogue One: A Star Wars Story,1056057273,532177324,523879949,2016.csv,2016,50.392846828109484,49.607153171890516
32,Aladdin,1050693953,355559216,695134737,2019.csv,2019,33.84041708670612,66.15958291329387
33,Pirates of the Caribbean: On Stranger Tides,1045713802,241071802,804642000,2011.csv,2011,23.053325062644625,76.94667493735537
34,Despicable Me 3,1034799409,264624300,770175109,2017.csv,2017,25.57252136969475,74.42747863030525
35,Finding Dory,1028570889,486295561,542275328,2016.csv,2016,47.278759898871684,52.721240101128316
36,Zootopia,1023784195,341268248,682515947,2016.csv,2016,33.33400238709487,66.66599761290513
37,The Hobbit: An Unexpected Journey,1017003568,303003568,714000000,2012.csv,2012,29.793756633113404,70.20624336688658
38,Despicable Me 2,970766005,368065385,602700620,2013.csv,2013,37.914943776796136,62.085056223203864
39,The Jungle Book,966550600,364001123,602549477,2016.csv,2016,37.65981036067848,62.34018963932152
40,Jumanji: Welcome to the Jungle,962077546,404515480,557562066,2017.csv,2017,42.04603690023133,57.95396309976868
41,The Hobbit: The Desolation of Smaug,958366855,258366855,700000000,2013.csv,2013,26.95907664711547,73.04092335288452
42,The Hobbit: The Battle of the Five Armies,956019788,255119788,700900000,2014.csv,2014,26.685617934092388,73.31438206590761
43,Bohemian Rhapsody,903655259,216428042,687227217,2018.csv,2018,23.950288546929155,76.04971145307084
44,Spectre,880674609,200074609,680600000,2015.csv,2015,22.718335121207065,77.28166487879294
45,Spider-Man: Homecoming,880166924,334201140,545965784,2017.csv,2017,37.9701998435924,62.0298001564076
46,Ice Age: Continental Drift,877244782,161321843,715922939,2012.csv,2012,18.389604168657225,81.61039583134277
47,The Secret Life of Pets,875457937,368384330,507073607,2016.csv,2016,42.07904394154804,57.92095605845196
48,Batman v Superman: Dawn of Justice,873634919,330360194,543274725,2016.csv,2016,37.81444477724682,62.18555522275317
49,Wolf Warrior 2,870325439,2721100,867604339,2017.csv,2017,0.3126531614572282,99.68734683854277
50,The Hunger Games: Catching Fire,865011746,424668047,440343699,2013.csv,2013,49.0939052520103,50.90609474798969
51,Guardians of the Galaxy Vol. 2,863756051,389813101,473942950,2017.csv,2017,45.12999944240043,54.87000055759956
52,Inside Out,857611174,356461711,501149463,2015.csv,2015,41.56449004009829,58.43550995990171
53,Venom,856085151,213515506,642569645,2018.csv,2018,24.94091922405041,75.05908077594958
54,Thor: Ragnarok,853977126,315058289,538918837,2017.csv,2017,36.893059475225336,63.10694052477467
55,The Twilight Saga: Breaking Dawn - Part 2,829746820,292324737,537422083,2012.csv,2012,35.23059443602327,64.76940556397673
56,Wonder Woman,821847012,412563408,409283604,2017.csv,2017,50.199538597336904,49.8004614026631
57,Fantastic Beasts and Where to Find Them,814037575,234037575,580000000,2016.csv,2016,28.750217703402697,71.2497822965973
58,Coco,807816196,210460015,597356181,2017.csv,2017,26.052958091471588,73.9470419085284
59,Jumanji: The Next Level,800059707,320314960,479744747,2019.csv,2019,40.03638193467978,59.96361806532021
60,Pirates of the Caribbean: Dead Men Tell No Tales,794861794,172558876,622302918,2017.csv,2017,21.709293024593403,78.2907069754066
61,Mission: Impossible - Fallout,791115104,220159104,570956000,2018.csv,2018,27.828959766643514,72.17104023335649
62,Fast & Furious 6,788679850,238679850,550000000,2013.csv,2013,30.263211365169273,69.73678863483073
63,Deadpool,782612155,363070709,419541446,2016.csv,2016,46.392163305973696,53.607836694026304
64,Guardians of the Galaxy,772776600,333176600,439600000,2014.csv,2014,43.11421955581988,56.885780444180114
65,Fast & Furious Presents: Hobbs & Shaw,759056935,173956935,585100000,2019.csv,2019,22.917508157671993,77.08249184232801
66,Maleficent,758410378,241410378,517000000,2014.csv,2014,31.831101604466706,68.16889839553329
67,The Amazing Spider-Man,757930663,262030663,495900000,2012.csv,2012,34.57185146235467,65.42814853764533
68,The Hunger Games: Mockingjay - Part 1,755356711,337135885,418220826,2014.csv,2014,44.632672231596814,55.367327768403186
69,Madagascar 3: Europe's Most Wanted,746921274,216391482,530529792,2012.csv,2012,28.971123133386612,71.02887686661339
70,Suicide Squad,746846894,325100054,421746840,2016.csv,2016,43.52967878848808,56.47032121151193
71,X-Men: Days of Future Past,746045700,233921534,512124166,2014.csv,2014,31.35485319465014,68.64514680534985
72,Monsters University,743559607,268492764,475066843,2013.csv,2013,36.10911102114238,63.89088897885762
73,Deadpool 2,734546611,318491426,416055185,2018.csv,2018,43.35891299891927,56.64108700108073
74,Ne Zha,726063471,3695533,722367938,2019.csv,2019,0.5089820859476899,99.49101791405232
75,Gravity,723192705,274092705,449100000,2013.csv,2013,37.90036916923823,62.09963083076177
76,Captain America: The Winter Soldier,714421503,259766572,454654931,2014.csv,2014,36.360407813760894,63.63959218623911
77,The Twilight Saga: Breaking Dawn - Part 1,712205856,281287133,430918723,2011.csv,2011,39.4952008089077,60.5047991910923
78,Dawn of the Planet of the Apes,710644566,208545589,502098977,2014.csv,2014,29.345976734028806,70.65402326597119
79,The Amazing Spider-Man 2,708982323,202853933,506128390,2014.csv,2014,28.611987410580337,71.38801258941967
80,It,700381748,327481748,372900000,2017.csv,2017,46.757607395559944,53.242392604440056
81,The Wandering Earth,699856699,5971413,693885286,2019.csv,2019,0.8532336703402763,99.14676632965971
82,Mission: Impossible - Ghost Protocol,694713380,209397903,485315477,2011.csv,2011,30.141625169217267,69.85837483078274
83,The Hunger Games,694394724,408010692,286384032,2012.csv,2012,58.757746552233314,41.24225344776669
84,Mission: Impossible - Rogue Nation,682714267,195042377,487671890,2015.csv,2015,28.56866868434727,71.43133131565274
85,Interstellar,677896797,188020017,489876780,2014.csv,2014,27.735787782457983,72.26421221754201
86,Doctor Strange,677718395,232641920,445076475,2016.csv,2016,34.32722524817996,65.67277475182004
87,Man of Steel,668045518,291045518,377000000,2013.csv,2013,43.56671965577052,56.43328034422947
88,Kung Fu Panda 2,665692281,165249063,500443218,2011.csv,2011,24.823641150196842,75.17635884980317
89,The Hunger Games: Mockingjay - Part 2,658344137,281723902,376620235,2015.csv,2015,42.792801844303504,57.207198155696496
90,Justice League,657924295,229024295,428900000,2017.csv,2017,34.81012887660578,65.18987112339421
91,Big Hero 6,657827828,222527828,435300000,2014.csv,2014,33.827670178769026,66.17232982123097
92,Fantastic Beasts: The Crimes of Grindelwald,654855901,159555901,495300000,2018.csv,2018,24.365039813545177,75.63496018645482
93,Thor: The Dark World,644783140,206362140,438421000,2013.csv,2013,32.004890822672564,67.99510917732744
94,Moana,643331111,248757044,394574067,2016.csv,2016,38.667031602642325,61.33296839735767
95,Sing,634151679,270395425,363756254,2016.csv,2016,42.63891967082532,57.36108032917468
96,The Martian,630161890,228433663,401728227,2015.csv,2015,36.24999648899745,63.750003511002554
97,Fast Five,626137675,209837675,416300000,2011.csv,2011,33.51302491101498,66.48697508898502
98,Men in Black 3,624026776,179020854,445005922,2012.csv,2012,28.68800841328001,71.31199158672
99,Ant-Man and the Wasp,622674139,216648740,406025399,2018.csv,2018,34.79327732285988,65.20672267714012
100,How to Train Your Dragon 2,621537519,177002924,444534595,2014.csv,2014,28.478236403939437,71.52176359606057
101,Logan,619021436,226277068,392744368,2017.csv,2017,36.55399552270109,63.446004477298914
102,Life of Pi,609016565,124987023,484029542,2012.csv,2012,20.522762463776335,79.47723753622367
103,Transformers: The Last Knight,605425157,130168683,475256474,2017.csv,2017,21.500375644284635,78.49962435571537
104,The Croods,587204668,187168425,400036243,2013.csv,2013,31.874478388853678,68.12552161114633
105,The Hangover Part II,586764305,254464305,332300000,2011.csv,2011,43.367379854505636,56.632620145494364
106,Ready Player One,582890172,137690172,445200000,2018.csv,2018,23.62197522177471,76.37802477822528
107,Operation Red Sea,579330426,1543547,577786879,2018.csv,2018,0.2664363773636843,99.73356362263631
108,Fifty Shades of Grey,569651467,166167230,403484237,2015.csv,2015,29.16998193212763,70.83001806787237
109,Kong: Skull Island,566652812,168052812,398600000,2017.csv,2017,29.657103686975084,70.34289631302492
110,The Smurfs,563749323,142614158,421135165,2011.csv,2011,25.297441997992433,74.70255800200756
111,Cars 2,559852396,191452396,368400000,2011.csv,2011,34.196941438114344,65.80305856188566
112,Puss in Boots,554987477,149260504,405726973,2011.csv,2011,26.894391348581724,73.10560865141828
113,The Mermaid,553810228,3232685,550577543,2016.csv,2016,0.5837170995693493,99.41628290043066
114,Ted,549368315,218815487,330552828,2012.csv,2012,39.8303799155217,60.16962008447829
115,American Sniper,547426372,350126372,197300000,2014.csv,2014,63.9586234621521,36.04137653784791
116,Detective Chinatown 2,544185156,1983984,542201172,2018.csv,2018,0.36457885301083076,99.63542114698917
117,X-Men: Apocalypse,543934105,155442489,388491616,2016.csv,2016,28.577448549581202,71.4225514504188
118,Sherlock Holmes: A Game of Shadows,543848418,186848418,357000000,2011.csv,2011,34.35670893134785,65.64329106865215
119,Cinderella,542351353,201151353,341200000,2015.csv,2015,37.08875286976559,62.911247130234415
120,World War Z,540007876,202359711,337648165,2013.csv,2013,37.473473997997765,62.526526002002235
121,Brave,538983207,237283207,301700000,2012.csv,2012,44.024230053609074,55.975769946390926
122,The Revenant,532950503,183637894,349312609,2015.csv,2015,34.45683848055211,65.54316151944789
123,The Meg,530243742,145443742,384800000,2018.csv,2018,27.42960085703378,72.57039914296621
124,Ralph Breaks the Internet,529323962,201091711,328232251,2018.csv,2018,37.99029052835511,62.00970947164489
125,Hotel Transylvania 3: Summer Vacation,528583774,167510016,361073758,2018.csv,2018,31.690343941583045,68.30965605841696
126,The Boss Baby,527965936,175003033,352962903,2017.csv,2017,33.1466522870521,66.85334771294791
127,Dunkirk,525245546,188045546,337200000,2017.csv,2017,35.80145465907482,64.19854534092518
128,Godzilla,524976069,200676069,324300000,2014.csv,2014,38.225755582013015,61.77424441798699
129,How to Train Your Dragon: The Hidden World,521799505,160799505,361000000,2019.csv,2019,30.81633912243746,69.18366087756255
130,Kung Fu Panda 3,521170825,143528619,377642206,2016.csv,2016,27.539649595696382,72.46035040430363
131,Ant-Man,519311965,180202163,339109802,2015.csv,2015,34.70017545234106,65.29982454765893
132,The Grinch,511595957,270620950,240975007,2018.csv,2018,52.89739809261237,47.10260190738763
133,Rio 2,498781117,131538435,367242682,2014.csv,2014,26.37197570572825,73.62802429427175
134,Oz the Great and Powerful,493311825,234911825,258400000,2013.csv,2013,47.619337930932424,52.380662069067576
135,Maleficent: Mistress of Evil,491730089,113929605,377800484,2019.csv,2019,23.169134358178354,76.83086564182165
136,War for the Planet of the Apes,490719763,146880162,343839601,2017.csv,2017,29.931576650194952,70.06842334980506
137,Teenage Mutant Ninja Turtles,485004754,191204754,293800000,2014.csv,2014,39.42327418918454,60.57672581081546
138,Rio,483866518,143619809,340246709,2011.csv,2011,29.681700150205476,70.31829984979453
139,Rise of the Planet of the Apes,481800873,176760185,305040688,2011.csv,2011,36.68739408863628,63.31260591136372
140,Hotel Transylvania 2,474800000,169700110,305099890,2015.csv,2015,35.74138795282224,64.25861204717775
141,San Andreas,473990832,155190832,318800000,2015.csv,2015,32.74131513159732,67.25868486840268
142,It Chapter Two,473093228,211593228,261500000,2019.csv,2019,44.725482310222375,55.274517689777625
143,Wreck-It Ralph,471222889,189422889,281800000,2012.csv,2012,40.198151113156136,59.801848886843864
144,The Lego Movie,468060692,257760692,210300000,2014.csv,2014,55.069929264643314,44.930070735356686
145,Bumblebee,467989645,127195589,340794056,2018.csv,2018,27.17914602576303,72.82085397423698
146,Star Trek Into Darkness,467365246,228778661,238586585,2013.csv,2013,48.95072172311246,51.049278276887534
147,Lucy,458863600,126663600,332200000,2014.csv,2014,27.603758502526677,72.39624149747333
148,Dying to Survive,451176639,0,451176639,2018.csv,2018,0.0,100.0
149,"My People, My Country",450064993,2356683,447708310,2019.csv,2019,0.5236317057878793,99.47636829421212
150,Thor,449326618,181030624,268295994,2011.csv,2011,40.289316668081305,59.7106833319187
151,La La Land,447407695,151101803,296305892,2016.csv,2016,33.77273227274287,66.22726772725713
152,Les Misérables,442299309,148809770,293489539,2012.csv,2012,33.64458568484899,66.35541431515101
153,Terminator Genisys,440603537,89760956,350842581,2015.csv,2015,20.372273134974854,79.62772686502514
154,Warcraft,439048914,47365290,391683624,2016.csv,2016,10.788157877097039,89.21184212290297
155,A Star Is Born,436188866,215288866,220900000,2018.csv,2018,49.35679995096436,50.64320004903564
156,The Greatest Showman,434993183,174340174,260653009,2017.csv,2017,40.078829005465124,59.921170994534876
157,Pokémon Detective Pikachu,433005346,144105346,288900000,2019.csv,2019,33.28026947731957,66.71973052268044
158,The Secret Life of Pets 2,430051293,158874395,271176898,2019.csv,2019,36.943126921374,63.056873078626
159,Rampage,428028233,101028233,327000000,2018.csv,2018,23.60317035441912,76.39682964558088
160,The Intouchables,426588510,10198820,416389690,2011.csv,2011,2.3907863810021515,97.60921361899784
161,Django Unchained,425368238,162805434,262562804,2012.csv,2012,38.27399872766241,61.72600127233759
162,The Captain,417282021,706572,416575449,2019.csv,2019,0.16932720904359308,99.83067279095641
163,Jason Bourne,415484914,162434410,253050504,2016.csv,2016,39.09514028709115,60.90485971290885
164,The Wolverine,414828246,132556852,282271394,2013.csv,2013,31.95463502743253,68.04536497256747
165,Kingsman: The Secret Service,414351546,128261724,286089822,2015.csv,2015,30.954807635736444,69.04519236426356
166,Pacific Rim,411002906,101802906,309200000,2013.csv,2013,24.769388370212642,75.23061162978736
167,Kingsman: The Golden Circle,410902662,100234838,310667824,2017.csv,2017,24.393815681826855,75.60618431817315
168,The Mummy,409231607,80227895,329003712,2017.csv,2017,19.6045206742792,80.3954793257208
169,Ice Age: Collision Course,408579038,64063008,344516030,2016.csv,2016,15.679465180981703,84.3205348190183
170,Alita: Battle Angel,404980543,85838210,319142333,2019.csv,2019,21.195638033405473,78.80436196659453
171,Prometheus,403354469,126477084,276877385,2012.csv,2012,31.356311562275017,68.64368843772498
172,Snow White and the Huntsman,396592829,155332381,241260448,2012.csv,2012,39.16671448439125,60.83328551560876
173,Mamma Mia! Here We Go Again,395044706,120634935,274409771,2018.csv,2018,30.537033699674488,69.46296630032552
174,Solo: A Star Wars Story,392924807,213767512,179157295,2018.csv,2018,54.40417815106289,45.59582184893712
175,The Wolf of Wall Street,392000694,116900694,275100000,2013.csv,2013,29.821552815924353,70.17844718407565
176,Independence Day: Resurgence,389681935,103144286,286537649,2016.csv,2016,26.468839516514926,73.53116048348508
177,Monster Hunt,387053506,32766,387020740,2015.csv,2015,0.008465496240718719,99.99153450375928
178,Godzilla: King of the Monsters,386600138,110500138,276100000,2019.csv,2019,28.58253971963145,71.41746028036854
179,Home,386041607,177397510,208644097,2015.csv,2015,45.95295086936056,54.04704913063944
180,1917,384919389,159227644,225691745,2019.csv,2019,41.36649089401937,58.63350910598063
181,Cars 3,383930656,152901115,231029541,2017.csv,2017,39.82519046356121,60.17480953643879
182,Fifty Shades Darker,381545846,114581250,266964596,2017.csv,2017,30.030794778984436,69.96920522101556
183,Taken 2,376141306,139854287,236287019,2012.csv,2012,37.181315843041176,62.818684156958824
184,G.I. Joe: Retaliation,375740705,122523060,253217645,2013.csv,2013,32.60840743884802,67.39159256115198
185,Spider-Man: Into the Spider-Verse,375540831,190241310,185299521,2018.csv,2018,50.65795628491859,49.34204371508141
186,Mad Max: Fury Road,374736354,153636354,221100000,2015.csv,2015,40.99851865453118,59.00148134546882
187,Once Upon a Time... In Hollywood,374375059,142502728,231872331,2019.csv,2019,38.06416174748436,61.93583825251564
188,The Adventures of Tintin,373993951,77591831,296402120,2011.csv,2011,20.746814431766037,79.25318556823396
189,Penguins of Madagascar,373515621,83850911,289664710,2014.csv,2014,22.44910421028951,77.5508957897105
190,Fifty Shades Freed,371985018,100407760,271577258,2018.csv,2018,26.992420431298125,73.00757956870187
191,Captain America: The First Avenger,370569774,176654505,193915269,2011.csv,2011,47.67105074252494,52.32894925747505
192,Edge of Tomorrow,370541256,100206256,270335000,2014.csv,2014,27.04321162013873,72.95678837986127
193,Gone Girl,369330363,167767189,201563174,2014.csv,2014,45.42469447604014,54.57530552395986
194,Hello Mr. Billionaire,366961907,0,366961907,2018.csv,2018,0.0,100.0
195,Shazam!,365971656,140371656,225600000,2019.csv,2019,38.35588185550632,61.64411814449369
196,The Nun,365550119,117450119,248100000,2018.csv,2018,32.129689718415875,67.87031028158412
197,Night at the Museum: Secret of the Tomb,363204635,113746621,249458014,2014.csv,2014,31.3175025973994,68.6824974026006
198,The Hangover Part III,362000072,112200072,249800000,2013.csv,2013,30.99448886297459,69.00551113702541
199,Monster Hunt 2,361682618,706153,360976465,2018.csv,2018,0.1952410662986298,99.80475893370136
200,Noah,359200044,101200044,258000000,2014.csv,2014,28.173728174710355,71.82627182528964
201,Hotel Transylvania,358375603,148313048,210062555,2012.csv,2012,41.38480598524448,58.615194014755524
202,Your Name.,357986087,5017246,352968841,2016.csv,2016,1.4015198305737508,98.59848016942625
203,The Legend of Tarzan,356700357,126643061,230057296,2016.csv,2016,35.50404660794887,64.49595339205113
204,The Great Gatsby,353641895,144840419,208801476,2013.csv,2013,40.9568043401645,59.04319565983549
205,Dumbo,353284621,114766307,238518314,2019.csv,2019,32.485508900768146,67.51449109923186
206,Murder on the Orient Express,352789811,102826543,249963268,2017.csv,2017,29.146687289106545,70.85331271089346
207,X-Men: First Class,352616690,146408305,206208385,2011.csv,2011,41.52052615546927,58.47947384453073
208,The Angry Birds Movie,352333929,107509366,244824563,2016.csv,2016,30.513486539640073,69.48651346035993
209,Now You See Me,351723989,117723989,234000000,2013.csv,2013,33.47056006464205,66.52943993535794
210,Peter Rabbit,351266433,115253424,236013009,2018.csv,2018,32.810827671655154,67.18917232834485
211,Titanic 2012 3D Release,350449521,57884114,292565407,2012.csv,2012,16.517104613191925,83.48289538680808
212,Mary Poppins Returns,349537494,171958438,177579056,2018.csv,2018,49.19599211865952,50.804007881340475
213,The Lorax,348840316,214030500,134809816,2012.csv,2012,61.354863581765585,38.64513641823441
214,The Maze Runner,348319861,102427862,245891999,2014.csv,2014,29.40626517992323,70.59373482007678
215,The Smurfs 2,347545360,71017784,276527576,2013.csv,2013,20.43410506185437,79.56589493814563
216,Trolls,346864462,153707064,193157398,2016.csv,2016,44.313292608223435,55.68670739177656
217,xXx: Return of Xander Cage,346118277,44898413,301219864,2017.csv,2017,12.971985585147241,87.02801441485276
218,Star Trek Beyond,343471816,158848340,184623476,2016.csv,2016,46.2478528369268,53.752147163073204
219,Alvin and the Chipmunks: Chipwrecked,342695435,133110742,209584693,2011.csv,2011,38.84228630007867,61.15771369992133
220,A Quiet Place,340939361,188024361,152915000,2018.csv,2018,55.14891576276521,44.85108423723479
221,300: Rise of an Empire,337580051,106580051,231000000,2014.csv,2014,31.571785916935003,68.428214083065
222,Journey 2: The Mysterious Island,335260290,103860290,231400000,2012.csv,2012,30.979001420060815,69.02099857993919
223,The Great Wall,334933831,45540830,289393001,2016.csv,2016,13.596963276008985,86.40303672399101
224,Now You See Me 2,334897606,65075540,269822066,2016.csv,2016,19.431473630778957,80.56852636922105
225,Never Say Die,334530869,0,334530869,2017.csv,2017,0.0,100.0
226,The Good Dinosaur,332207671,123087120,209120551,2015.csv,2015,37.05125761530052,62.94874238469947
227,22 Jump Street,331333876,191719337,139614539,2014.csv,2014,57.86288420445123,42.13711579554878
228,Crazy Alien,327598891,0,327598891,2019.csv,2019,0.0,100.0
229,John Wick: Chapter 3 - Parabellum,326709727,171015687,155694040,2019.csv,2019,52.34484096030603,47.65515903969397
230,Taken 3,326479141,89256424,237222717,2015.csv,2015,27.339089329446626,72.66091067055338
231,The SpongeBob Movie: Sponge Out of Water,325186032,162994032,162192000,2015.csv,2015,50.123318949935715,49.87668105006429
232,Green Book,321752656,85080171,236672485,2018.csv,2018,26.442725308847177,73.55727469115281
233,The Conjuring 2,320392818,102470008,217922810,2016.csv,2016,31.982617038562957,68.01738296143705
234,The Conjuring,319494638,137400141,182094497,2013.csv,2013,43.005460705102664,56.994539294897336
235,The Expendables 2,314975955,85028192,229947763,2012.csv,2012,26.995137454222494,73.0048625457775
236,Maze Runner: The Scorch Trials,312296056,81697192,230598864,2015.csv,2015,26.16017411375826,73.83982588624174
237,Resident Evil: The Final Chapter,312242626,26830068,285412558,2016.csv,2016,8.5926986791355,91.40730132086449
238,The Lego Batman Movie,311950384,175750384,136200000,2017.csv,2017,56.33921066114155,43.66078933885845
239,Knives Out,311605581,165363234,146242347,2019.csv,2019,53.06812332093628,46.93187667906372
240,The Ex-File 3: The Return of The Exes,307592427,838959,306753468,2017.csv,2017,0.2727502130603495,99.72724978693965
241,The Fault in Our Stars,307166834,124872350,182294484,2014.csv,2014,40.652940414784496,59.3470595852155
242,Rise of the Guardians,306941670,103412758,203528912,2012.csv,2012,33.691338813657985,66.30866118634202
243,Annabelle: Creation,306515884,102092201,204423683,2017.csv,2017,33.30731173461797,66.69268826538203
244,Wonder,305937718,132422809,173514909,2017.csv,2017,43.284237676114195,56.71576232388581
245,Skyscraper,304868961,68420120,236448841,2018.csv,2018,22.442468323300382,77.55753167669963
246,A Good Day to Die Hard,304654182,67349198,237304984,2013.csv,2013,22.106769569964413,77.89323043003559
247,Dangal,303723636,12391761,291331875,2016.csv,2016,4.079946217949267,95.92005378205073
248,Passengers,303144152,100014699,203129453,2016.csv,2016,32.992455351736425,67.00754464826358
249,Battleship,303025485,65422625,237602860,2012.csv,2012,21.589809517176416,78.41019048282358
250,Wrath of the Titans,301970083,83670083,218300000,2012.csv,2012,27.708070338875256,72.29192966112474
251,Alice Through the Looking Glass,299457024,77041381,222415643,2016.csv,2016,25.7270241889534,74.27297581104659
252,Real Steel,299268508,85468508,213800000,2011.csv,2011,28.559138604720815,71.44086139527919
253,Ocean's Eight,297718711,140218711,157500000,2018.csv,2018,47.09771533304804,52.90228466695195
254,The Divergent Series: Insurgent,297002527,130179072,166823455,2015.csv,2015,43.83096444159211,56.169035558407884
255,Miss Peregrine's Home for Peculiar Children,296482446,87242834,209239612,2016.csv,2016,29.425969455203425,70.57403054479657
256,Ferdinand,296069199,84410380,211658819,2017.csv,2017,28.510355107894895,71.4896448921051
257,Pacific Rim: Uprising,290930148,59874525,231055623,2018.csv,2018,20.5803782837934,79.4196217162066
258,Divergent,288885818,150947895,137937923,2014.csv,2014,52.25174985917792,47.74825014082207
259,Bridesmaids,288383523,169106725,119276798,2011.csv,2011,58.63952393701772,41.36047606298228
260,Maze Runner: The Death Cure,288175335,58032443,230142892,2018.csv,2018,20.137893827728178,79.86210617227182
261,Pitch Perfect 2,287144079,184296230,102847849,2015.csv,2015,64.18249355578737,35.817506444212626
262,Oblivion,286168572,89107235,197061337,2013.csv,2013,31.13802273158074,68.86197726841927
263,Elysium,286140700,93050117,193090583,2013.csv,2013,32.51900795657521,67.48099204342479
264,John Carter,284139100,73078100,211061000,2012.csv,2012,25.719128412809077,74.28087158719092
265,Turbo,282570682,83028128,199542554,2013.csv,2013,29.383136074959115,70.61686392504089
266,Paddington,282370135,76271832,206098303,2014.csv,2014,27.01129565277858,72.98870434722143
267,Split,278454358,138291365,140162993,2017.csv,2017,49.66392553281569,50.33607446718431
268,The Bourne Legacy,276144750,113203870,162940880,2012.csv,2012,40.99439514964525,59.00560485035476
269,Mr. Peabody & Sherman,275698039,111506430,164191609,2014.csv,2014,40.445129898076644,59.55487010192336
270,Lincoln,275293450,182207973,93085477,2012.csv,2012,66.18681737614898,33.81318262385102
271,Tomb Raider,274650803,58250803,216400000,2018.csv,2018,21.209041577060308,78.7909584229397
272,Cloudy with a Chance of Meatballs 2,274325949,119793567,154532382,2013.csv,2013,43.66833230202368,56.331667697976314
273,Neighbors,270665134,150157400,120507734,2014.csv,2014,55.47718606416444,44.522813935835565
274,We're the Millers,269994119,150394119,119600000,2012.csv,2012,55.702738843730145,44.297261156269855
275,Epic,268426634,107518682,160907952,2013.csv,2013,40.05514668861064,59.94485331138936
276,Exodus: Gods and Kings,268175631,65014513,203161118,2014.csv,2014,24.243259075243863,75.75674092475614
277,Terminator: Dark Fate,261119292,62253077,198866215,2019.csv,2019,23.840856998034447,76.15914300196556
278,The Lone Ranger,260502115,89302115,171200000,2013.csv,2013,34.280763900899615,65.71923609910039
279,Super 8,260095986,127004179,133091807,2011.csv,2011,48.82973434276683,51.17026565723317
280,Mojin: The Lost Legend,259368448,1243810,258124638,2015.csv,2015,0.4795533186827721,99.52044668131722
281,Blade Runner 2049,259239658,92054159,167185499,2017.csv,2017,35.509288860425826,64.49071113957417
282,Parasite,258632621,53369749,205262872,2019.csv,2019,20.63535094438068,79.36464905561932
283,Kung Fu Yoga,257743016,362657,257380359,2017.csv,2017,0.14070487946800467,99.859295120532
284,Annabelle,257047661,84273813,172773848,2014.csv,2014,32.78528684997449,67.2147131500255
285,Lost in Hong Kong,256283912,1302281,254981631,2015.csv,2015,0.5081399725161054,99.4918600274839
286,Pegasus,255863112,0,255863112,2019.csv,2019,0.0,100.0
287,Halloween,255485178,159342015,96143163,2018.csv,2018,62.36839892136522,37.63160107863479
288,Get Out,255407969,176040665,79367304,2017.csv,2017,68.92528282858707,31.074717171412924
289,Us,255184580,175084580,80100000,2019.csv,2019,68.61095603817441,31.389043961825593
290,Baahubali 2: The Conclusion,254158390,20186659,233971731,2017.csv,2017,7.942550706274147,92.05744929372585
291,Men in Black: International,253890701,80001807,173888894,2019.csv,2019,31.510333653377877,68.48966634662213
292,X-Men: Dark Phoenix,252442974,65845974,186597000,2019.csv,2019,26.083504308580995,73.916495691419
293,American Hustle,251171807,150117807,101054000,2013.csv,2013,59.76698133162692,40.23301866837308
294,Journey to the West: The Demons Strike Back,247585244,880346,246704898,2017.csv,2017,0.3555728870497629,99.64442711295024
295,Glass,246999039,111048468,135950571,2019.csv,2019,44.95906884884682,55.04093115115318
296,Grown Ups 2,246984278,133668525,113315753,2013.csv,2013,54.120256593822546,45.87974340617746
297,The Peanuts Movie,246233113,130178411,116054702,2015.csv,2015,52.86795484732389,47.13204515267611
298,Rango,245724603,123477607,122246996,2011.csv,2011,50.25040451484624,49.749595485153755
299,Teenage Mutant Ninja Turtles: Out of the Shadows,245623848,82051601,163572247,2016.csv,2016,33.40538863311025,66.59461136688975
300,Dark Shadows,245527149,79727149,165800000,2012.csv,2012,32.47182616045446,67.52817383954553
301,The Bravest,245179562,290217,244889345,2019.csv,2019,0.11836916488169598,99.8816308351183
302,Pixels,244874809,78747585,166127224,2015.csv,2015,32.15830379677805,67.84169620322194
303,Hercules,244819862,72688614,172131248,2014.csv,2014,29.690652304999666,70.30934769500034
304,After Earth,243611982,60522097,183089885,2013.csv,2013,24.84364541642291,75.15635458357708
305,Daddy's Home,242786137,150357137,92429000,2015.csv,2015,61.929869167118056,38.070130832881944
306,RoboCop,242688965,58607007,184081958,2014.csv,2014,24.149020125410317,75.85097987458968
307,Alien: Covenant,240891763,74262031,166629732,2017.csv,2017,30.82796608533269,69.17203391466731
308,Sully,240797623,125070033,115727590,2016.csv,2016,51.93989518742052,48.06010481257948
309,Assassin's Creed,240697856,54647948,186049908,2016.csv,2016,22.70396126835463,77.29603873164537
310,Resident Evil: Retribution,240159255,42345531,197813724,2012.csv,2012,17.632271136084263,82.36772886391573
311,Planes,239258712,90288712,148970000,2013.csv,2013,37.73685448912724,62.26314551087276
312,Crazy Rich Asians,238532921,174532921,64000000,2018.csv,2018,73.16932198218458,26.830678017815412
313,Silver Linings Playbook,236412453,132092958,104319495,2012.csv,2012,55.87394247797937,44.12605752202063
314,Hidden Figures,235956898,169607287,66349611,2016.csv,2016,71.88062245164792,28.11937754835207
315,Spy,235666219,110825712,124840507,2015.csv,2015,47.02655835455145,52.97344164544856
316,American Reunion,234989584,57011521,177978063,2012.csv,2012,24.261297045404362,75.73870295459564
317,Alvin and the Chipmunks: The Road Chip,234798636,85886987,148911649,2015.csv,2015,36.578997418025885,63.421002581974115
318,The Imitation Game,233555708,91125683,142430025,2014.csv,2014,39.016679909188944,60.983320090811056
319,The Girl with the Dragon Tattoo,232617430,102515793,130101637,2011.csv,2011,44.070555246010585,55.92944475398941
320,Argo,232325503,136025503,96300000,2012.csv,2012,58.549535562611055,41.45046443738895
321,Annabelle Comes Home,231252591,74152591,157100000,2019.csv,2019,32.065626023623665,67.93437397637634
322,Ghostbusters,229147509,128350574,100796935,2016.csv,2016,56.01220565744837,43.98779434255163
323,Goodbye Mr. Loser,228122928,1293626,226829302,2015.csv,2015,0.5670740820931424,99.43292591790686
324,Paddington 2,227978523,40891591,187086932,2017.csv,2017,17.936597913655223,82.06340208634477
325,The Green Hornet,227817248,98780042,129037206,2011.csv,2011,43.35933423267408,56.64066576732593
326,Youth,227091290,1891956,225199334,2017.csv,2017,0.833125744276674,99.16687425572333
327,Baby Driver,226945087,107825862,119119225,2017.csv,2017,47.51187321362899,52.48812678637101
328,Immortals,226904017,83504017,143400000,2011.csv,2011,36.80147143450528,63.198528565494726
329,Hansel & Gretel: Witch Hunters,226349749,55703475,170646274,2013.csv,2013,24.60947062945495,75.39052937054504
330,Better Days,225918798,1921657,223997141,2019.csv,2019,0.8505963279779843,99.14940367202202
331,Valerian and the City of a Thousand Planets,225874228,41189488,184684740,2017.csv,2017,18.235585513545175,81.76441448645483
332,Ford v Ferrari,225508210,117624357,107883853,2019.csv,2019,52.1596783549477,47.840321645052306
333,Non-Stop,222809600,92168600,130641000,2014.csv,2014,41.36652998793589,58.633470012064116
334,Geostorm,221600160,33700160,187900000,2017.csv,2017,15.207642449355632,84.79235755064437
335,Inferno,220021259,34343574,185677685,2016.csv,2016,15.609207108482185,84.39079289151782
336,Green Lantern,219851172,116601172,103250000,2011.csv,2011,53.03641137742036,46.96358862257964
337,Captain Phillips,218791811,107100855,111690956,2013.csv,2013,48.951034552202685,51.048965447797315
338,Jack Reacher,218340595,80070736,138269859,2012.csv,2012,36.67239983476275,63.32760016523725
339,The Emoji Movie,217776646,86089513,131687133,2017.csv,2017,39.53110426725922,60.468895732740776
340,Dracula Untold,217124280,56280355,160843925,2014.csv,2014,25.92080213230874,74.07919786769126
341,Central Intelligence,216972543,127440871,89531672,2016.csv,2016,58.735943837833894,41.2640561621661
342,The Help,216639112,169708112,46931000,2011.csv,2011,78.33678343363962,21.663216566360372
343,Little Women,216601214,108101214,108500000,2019.csv,2019,49.90794465260938,50.09205534739062
344,Bad Teacher,216197492,100292856,115904636,2011.csv,2011,46.389463204318766,53.61053679568124
345,Ted 2,215863606,81476385,134387221,2015.csv,2015,37.744382441197615,62.25561755880239
346,Just Go with It,214945591,103028109,111917482,2011.csv,2011,47.93218066054679,52.067819339453216
347,The Expendables 3,214657577,39322544,175335033,2014.csv,2014,18.318730952599918,81.68126904740008
348,Creed II,214215889,115715889,98500000,2018.csv,2018,54.018350151421316,45.98164984857869
349,Smallfoot,214040103,83240103,130800000,2018.csv,2018,38.88995652370808,61.11004347629192
350,Into the Woods,212902372,128002372,84900000,2014.csv,2014,60.12256735213829,39.87743264786172
351,Bridget Jones's Baby,211952420,24252420,187700000,2016.csv,2016,11.442388815376583,88.55761118462343
352,Battle Los Angeles,211819354,83552429,128266925,2011.csv,2011,39.445134461131445,60.55486553886856
353,Fury,211817906,85817906,126000000,2014.csv,2014,40.51494400100433,59.48505599899566
354,Horrible Bosses,209838559,117538559,92300000,2011.csv,2011,56.01380392628411,43.98619607371589
355,Us and Them,209221380,0,209221380,2018.csv,2018,0.0,100.0
356,Tomorrowland,209035668,93436322,115599346,2015.csv,2015,44.698745861878464,55.301254138121536
357,Me Before You,208314186,56245075,152069111,2016.csv,2016,27.000117505199572,72.99988249480043
358,Safe House,208076205,126373434,81702771,2012.csv,2012,60.734207450582836,39.26579254941717
359,Paranormal Activity 3,207039844,104028807,103011037,2011.csv,2011,50.245790853667756,49.754209146332244
360,London Has Fallen,205754447,62524260,143230187,2016.csv,2016,30.387804935268303,69.6121950647317
361,Journey to the West,205637183,18058,205619125,2013.csv,2013,0.008781485788005567,99.991218514212
362,White House Down,205366737,73103784,132262953,2013.csv,2013,35.596701329485505,64.4032986705145
363,A Dog's Purpose,205035819,64508620,140527199,2017.csv,2017,31.46212223533489,68.53787776466511
364,Everest,203427584,43482270,159945314,2015.csv,2015,21.37481512831613,78.62518487168387
365,Arrival,203388186,100546139,102842047,2016.csv,2016,49.435584719753585,50.56441528024641
366,Need for Speed,203277636,43577636,159700000,2014.csv,2014,21.43749644943726,78.56250355056274
367,The Addams Family,203044905,100044905,103000000,2019.csv,2019,49.272305059809305,50.727694940190695
368,Straight Outta Compton,201634991,161197785,40437206,2015.csv,2015,79.94534291917617,20.054657080823834
369,21 Jump Street,201585328,138447667,63137661,2012.csv,2012,68.67943633278708,31.320563667212927
370,Percy Jackson: Sea of Monsters,199850315,68559554,131290761,2013.csv,2013,34.30545205795647,65.69454794204353
371,Total Recall,198467168,58877969,139589199,2012.csv,2012,29.6663521696445,70.33364783035549
372,The Island,198326350,670883,197655467,2018.csv,2018,0.3382722467286874,99.66172775327131
373,The Impossible,198087212,19019882,179067330,2012.csv,2012,9.601771769093302,90.3982282309067
374,Lost in Thailand,197757387,57387,197700000,2012.csv,2012,0.029018890707733717,99.97098110929227
375,Christopher Robin,197744377,99215042,98529335,2018.csv,2018,50.173382174098435,49.82661782590157
376,Jack the Giant Slayer,197687603,65187603,132500000,2013.csv,2013,32.97505863329225,67.02494136670776
377,Smurfs: The Lost Village,197183546,45020282,152163264,2017.csv,2017,22.831662637814617,77.16833736218538
378,The Other Woman,196710396,83911193,112799203,2014.csv,2014,42.65722336301941,57.34277663698059
379,The Vow,196114570,125014030,71100540,2012.csv,2012,63.745406575350316,36.254593424649684
380,The Shape of Water,195333312,63859435,131473877,2017.csv,2017,32.692547085875454,67.30745291412455
381,Rocketman,195320400,96368160,98952240,2019.csv,2019,49.33850227625993,50.66149772374007
382,The BFG,195243411,55483770,139759641,2016.csv,2016,28.417742609506035,71.58225739049396
383,The Intern,194564672,75764672,118800000,2015.csv,2015,38.940610965591944,61.05938903440805
384,Gnomeo & Juliet,193967670,99967670,94000000,2011.csv,2011,51.538315637858624,48.46168436214138
385,Weathering with You,193932489,8056636,185875853,2019.csv,2019,4.154350847319863,95.84564915268014
386,Downton Abbey,193795496,96854135,96941361,2019.csv,2019,49.97749534901472,50.02250465098529
387,The Monkey King 2,193678298,709982,192968316,2016.csv,2016,0.3665779838689,99.6334220161311
388,The Equalizer,192330738,101530738,90800000,2014.csv,2014,52.789657574131496,47.210342425868504
389,The Lego Movie 2: The Second Part,192306508,105806508,86500000,2019.csv,2019,55.01972299346208,44.98027700653792
390,Sheep Without a Shepherd,191602146,0,191602146,2019.csv,2019,0.0,100.0
391,The Equalizer 2,190400157,102084362,88315795,2018.csv,2018,53.615692134119406,46.384307865880594
392,The White Storm 2: Drug Lords,189396380,609461,188786919,2019.csv,2019,0.3217912612690908,99.67820873873092
393,Breakup Buddies,189017596,777896,188239700,2014.csv,2014,0.41154686995384276,99.58845313004616
394,The Secret Life of Walter Mitty,188133322,58236838,129896484,2013.csv,2013,30.955089391341318,69.04491060865868
395,Project Gutenberg,188116796,0,188116796,2018.csv,2018,0.0,100.0
396,12 Years a Slave,187733202,56671993,131061209,2013.csv,2013,30.187517389704993,69.812482610295
397,Mr. Popper's Penguins,187361754,68224452,119137302,2011.csv,2011,36.413222305764705,63.586777694235295
398,Jian Bing Man,186683536,0,186683536,2015.csv,2015,0.0,100.0
399,Hugo,185770160,73864507,111905653,2011.csv,2011,39.761233451055865,60.238766548944135
400,The Lion King 2011 3D Release,185542001,94242001,91300000,2011.csv,2011,50.792812674258045,49.20718732574195
401,Pitch Perfect 3,185400345,104897530,80502815,2017.csv,2017,56.57892923554161,43.42107076445839
402,Hop,183953723,108085305,75868418,2011.csv,2011,58.75679123928359,41.24320876071641
403,Bad Moms,183936074,113257297,70678777,2016.csv,2016,61.574271178583494,38.42572882141651
404,Jupiter Ascending,183887723,47387723,136500000,2015.csv,2015,25.769922117095334,74.23007788290467
405,Stand by Me Doraemon,183442714,0,183442714,2014.csv,2014,0.0,100.0
406,Storks,183388953,72679278,110709675,2016.csv,2016,39.63121922616571,60.36878077383429
407,Mirror Mirror,183018522,64935167,118083355,2012.csv,2012,35.48010676209045,64.51989323790956
408,From Vegas to Macau III,181732879,0,181732879,2016.csv,2016,0.0,100.0
409,Daddy's Home 2,180613180,104029443,76583737,2017.csv,2017,57.597924470406866,42.402075529593134
410,Hacksaw Ridge,180563636,67209615,113354021,2016.csv,2016,37.22212095906177,62.77787904093823
411,The Post,179769457,81903458,97865999,2017.csv,2017,45.56027445752367,54.439725542476324
412,The Dictator,179379533,59650222,119729311,2012.csv,2012,33.25363880839181,66.74636119160819
413,Allegiant,179246868,66184051,113062817,2016.csv,2016,36.923407219589464,63.076592780410536
414,Abominable,179053956,60716390,118337566,2019.csv,2019,33.909549588505044,66.09045041149496
415,Baywatch,177856751,58060186,119796565,2017.csv,2017,32.644353207599075,67.35564679240092
416,War Horse,177584879,79884879,97700000,2011.csv,2011,44.98405463902137,55.01594536097863
417,Lee Daniels' The Butler,177313795,116632095,60681700,2013.csv,2013,65.77722562421046,34.22277437578954
418,The Descendants,177243185,82584160,94659025,2011.csv,2011,46.59370119082435,53.40629880917566
419,The Hitman's Bodyguard,176586701,75468583,101118118,2017.csv,2017,42.73741033306919,57.26258966693081
420,Looper,176506819,66486205,110020614,2012.csv,2012,37.6677826820957,62.3322173179043
421,Serial (Bad) Weddings,176404493,0,176404493,2014.csv,2014,0.0,100.0
422,Ip Man 4: The Finale,176345966,3956031,172389935,2019.csv,2019,2.243335126815433,97.75666487318456
423,The Monkey King Havoc in Heavens Palace,175835580,0,175835580,2014.csv,2014,0.0,100.0
424,Cowboys & Aliens,174822325,100240551,74581774,2011.csv,2011,57.33852984737504,42.66147015262496
425,The Mule,174804407,103804407,71000000,2018.csv,2018,59.383175047754946,40.616824952245054
426,Identity Thief,173965010,134506920,39458090,2013.csv,2013,77.31837568945618,22.681624310543828
427,The Nutcracker and the Four Realms,173961069,54858851,119102218,2018.csv,2018,31.53513100106323,68.46486899893677
428,In Time,173930596,37520095,136410501,2011.csv,2011,21.5718774401256,78.4281225598744
429,Operation Mekong,173839072,800012,173039060,2016.csv,2016,0.46020264075040623,99.53979735924959
430,Creed,173567581,109767581,63800000,2015.csv,2015,63.241983536084426,36.758016463915574
431,Gemini Man,173469516,48546770,124922746,2019.csv,2019,27.98576436911255,72.01423563088744
432,The Girl on the Train,173185859,75395035,97790824,2016.csv,2016,43.5341750390833,56.4658249609167
433,The Grand Budapest Hotel,172936941,59301324,113635617,2014.csv,2014,34.2907210322403,65.7092789677597
434,Spies in Disguise,171616764,66757013,104859751,2019.csv,2019,38.89888810629246,61.10111189370754
435,John Wick: Chapter 2,171539887,92029184,79510703,2017.csv,2017,53.6488542749244,46.3511457250756
436,Anchorman 2: The Legend Continues,171464676,125168368,46296308,2013.csv,2013,72.99950690718362,27.00049309281639
437,Chinese Zodiac,170525083,0,170525083,2012.csv,2012,0.0,100.0
438,Olympus Has Fallen,170270201,98925640,71344561,2013.csv,2013,58.09920903305916,41.90079096694083
439,Zookeeper,169852759,80360843,89491916,2011.csv,2011,47.312062207950355,52.687937792049645
440,Dumb and Dumber To,169837010,86208010,83629000,2014.csv,2014,50.75926030492411,49.24073969507589
441,Ghost in the Shell,169801921,40563557,129238364,2017.csv,2017,23.888750351652384,76.11124964834762
442,Insidious: The Last Key,167885588,67745330,100140258,2018.csv,2018,40.35208191902691,59.64791808097309
443,Fantastic Four,167882881,56117548,111765333,2015.csv,2015,33.426605301108694,66.5733946988913
444,Magic Mike,167739368,113721571,54017797,2012.csv,2012,67.79658964733908,32.203410352660924
445,Bridge of Spies,165478348,72313754,93164594,2015.csv,2015,43.69982833041094,56.30017166958906
446,The Muppets,165184237,88631237,76553000,2011.csv,2011,53.655989584526765,46.34401041547324
447,The Huntsman: Winter's War,164989338,48390190,116599148,2016.csv,2016,29.32928308373478,70.67071691626522
448,From Vegas to Macau II,163877532,0,163877532,2015.csv,2015,0.0,100.0
449,The Magnificent Seven,162360636,93432655,68927981,2016.csv,2016,57.54637164638847,42.45362835361152
450,Jack Reacher: Never Go Back,162146076,58697076,103449000,2016.csv,2016,36.20012117962077,63.79987882037922
451,Insidious: Chapter 2,161919318,83586447,78332871,2013.csv,2013,51.62228203060983,48.37771796939016
452,Limitless,161849455,79249455,82600000,2011.csv,2011,48.9649192825518,51.0350807174482
453,Flight,161772375,93772375,68000000,2012.csv,2012,57.96562917494411,42.03437082505588
454,Into the Storm,161502194,47602194,113900000,2014.csv,2014,29.474642307336087,70.52535769266392
455,Unbroken,161459297,115637895,45821402,2014.csv,2014,71.62046233856698,28.379537661433023
456,The Predator,160542134,51024708,109517426,2018.csv,2018,31.782751810188348,68.21724818981166
457,"Three Billboards Outside Ebbing, Missouri",160192031,54513740,105678291,2017.csv,2017,34.03024461310438,65.96975538689563
458,Underworld: Awakening,160112671,62321039,97791632,2012.csv,2012,38.92323987275186,61.07676012724814
459,Johnny English Reborn,160078586,8305970,151772616,2011.csv,2011,5.188682763602123,94.81131723639787
460,Happy Feet Two,159196259,64006466,95189793,2011.csv,2011,40.20601137367179,59.79398862632821
461,Johnny English Strikes Again,158970776,4412170,154558606,2018.csv,2018,2.7754598115568108,97.22454018844319
462,Focus,158762963,53862963,104900000,2015.csv,2015,33.92665517334795,66.07334482665205
463,Goosebumps,158260952,80080379,78180573,2015.csv,2015,50.60021312142745,49.39978687857255
464,Final Destination 5,157887643,42587643,115300000,2011.csv,2011,26.973385751283907,73.02661424871609
465,Don't Breathe,157761002,89217875,68543127,2016.csv,2016,56.55255346311758,43.44744653688242
466,Hustlers,157563598,104963598,52600000,2019.csv,2019,66.61665469203109,33.383345307968916
467,Ip Man 3,156954938,2679437,154275501,2015.csv,2015,1.7071377518558861,98.2928622481441
468,The Climbers,156892866,487157,156405709,2019.csv,2019,0.31050296448788184,99.68949703551212
469,This Means War,156491279,54760791,101730488,2012.csv,2012,34.99287075288074,65.00712924711925
470,The Hateful Eight,155760117,54117416,101642701,2015.csv,2015,34.74407765114866,65.25592234885134
471,Escape Room,155712077,57005601,98706476,2019.csv,2019,36.60962084527329,63.39037915472671
472,The Monuments Men,155641650,78031620,77610030,2014.csv,2014,50.13543611237738,49.86456388762262
473,The Accountant,155160045,86260045,68900000,2016.csv,2016,55.594238194504264,44.405761805495736
474,Lone Survivor,154802912,125095601,29707311,2013.csv,2013,80.80959161801815,19.190408381981857
475,Yesterday,154608507,73286650,81321857,2019.csv,2019,47.401434385496,52.59856561450399
476,Ride Along,154468902,134938200,19530702,2014.csv,2014,87.35622397315933,12.643776026840664
477,Monkey King: Hero Is Back,153262397,0,153262397,2015.csv,2015,0.0,100.0
478,Tower Heist,152930623,78046570,74884053,2011.csv,2011,51.03397113604906,48.966028863950946
479,Duckweed,152894264,471575,152422689,2017.csv,2017,0.30843210704098095,99.69156789295901
480,Bad Grandpa,151826547,102003019,49823528,2013.csv,2013,67.18391547164674,32.816084528353265
481,47 Ronin,151783839,38362475,113421364,2013.csv,2013,25.274413437388414,74.72558656261158
482,Midnight in Paris,151672318,56817045,94855273,2011.csv,2011,37.46039208024763,62.53960791975237
483,Red Sparrow,151572634,46874505,104698129,2018.csv,2018,30.925440670246584,69.07455932975341
484,Darkest Hour,150847207,56468410,94378797,2017.csv,2017,37.43417668979446,62.56582331020554
485,Gods of Egypt,150680864,31153464,119527400,2015.csv,2015,20.675129656808977,79.32487034319102
486,I Am Number Four,149878437,55100437,94778000,2011.csv,2011,36.76341847626821,63.23658152373179
487,Jack and Jill,149673788,74158157,75515631,2011.csv,2011,49.54652246791535,50.45347753208465
488,Friends with Benefits,149542245,55802754,93739491,2011.csv,2011,37.31571235940721,62.68428764059279
489,No Strings Attached,149228077,70662220,78565857,2011.csv,2011,47.3518264260686,52.6481735739314
490,Lights Out,148868835,67268835,81600000,2016.csv,2016,45.186647023871714,54.813352976128286
491,King Arthur: Legend of the Sword,148675066,39175066,109500000,2017.csv,2017,26.34945257061463,73.65054742938537
492,RED 2,148075565,53262560,94813005,2013.csv,2013,35.969850933879606,64.0301490661204
493,The Angry Birds Movie 2,147792047,41667116,106124931,2019.csv,2019,28.19307049722371,71.80692950277628
494,Arthur Christmas,147419472,46462469,100957003,2011.csv,2011,31.517185870805452,68.48281412919455
495,Source Code,147332697,54712227,92620470,2011.csv,2011,37.135156088264644,62.864843911735356
496,Planes: Fire & Rescue,146965787,59165787,87800000,2014.csv,2014,40.258204448631304,59.7417955513687
497,The Last Witch Hunter,146936910,27367660,119569250,2015.csv,2015,18.625449521158437,81.37455047884157
498,Angel Has Fallen,146661977,69030436,77631541,2019.csv,2019,47.0677113537069,52.9322886462931
499,Mama,146428180,71628180,74800000,2013.csv,2013,48.916936616981786,51.083063383018214
500,Time Raiders,145819137,0,145819137,2016.csv,2016,0.0,100.0
501,The Foreigner,145374099,34393507,110980592,2017.csv,2017,23.658620921186245,76.34137907881376
502,"Crazy, Stupid, Love.",145051197,84351197,60700000,2011.csv,2011,58.15270659227997,41.84729340772003
503,Pete's Dragon,143695338,76233151,67462187,2016.csv,2016,53.05193060612725,46.94806939387275
504,More Than Blue,142958164,722669,142235495,2018.csv,2018,0.5055108290282743,99.49448917097172
505,Paranormal Activity 4,142802657,53885000,88917657,2012.csv,2012,37.733891744045074,62.26610825595493
506,Power Rangers,142337240,85364450,56972790,2017.csv,2017,59.97337731151735,40.02662268848265
507,New Year's Eve,142044638,54544638,87500000,2011.csv,2011,38.399645891596414,61.600354108403586
508,The Taking of Tiger Mountain,141654055,228984,141425071,2014.csv,2014,0.16165015537324365,99.83834984462676
509,Trainwreck,140795793,110212700,30583093,2015.csv,2015,78.27840424180856,21.72159575819144
510,Sausage Party,140705322,97685686,43019636,2016.csv,2016,69.42572221966131,30.574277780338686
511,Girls Trip,140552359,115171585,25380774,2017.csv,2017,81.94212165446473,18.057878345535276
512,Step Up Revolution,140470746,35074677,105396069,2012.csv,2012,24.969381881121354,75.03061811887865
513,Lion,140312928,51738905,88574023,2016.csv,2016,36.87394008341127,63.12605991658873
514,Mr. Six,139191345,1415450,137775895,2015.csv,2015,1.0169094924688027,98.9830905075312
515,The Admiral: Roaring Currents,138342258,2589811,135752447,2014.csv,2014,1.8720317547513212,98.12796824524868
516,Let's Be Cops,138224951,82390774,55834177,2014.csv,2014,59.606296405921675,40.393703594078325
517,Escape Plan,137328301,25135965,112192336,2013.csv,2013,18.303557836923943,81.69644216307606
518,The First Purge,137056262,69488745,67567517,2018.csv,2018,50.70089026650968,49.299109733490326
519,Annie,136853506,85911262,50942244,2014.csv,2014,62.77607677804031,37.223923221959694
520,The Best Exotic Marigold Hotel,136836156,46412041,90424115,2012.csv,2012,33.91796609662142,66.08203390337857
521,How Long Will I Love U,136796719,746933,136049786,2018.csv,2018,0.5460167505918033,99.4539832494082
522,Skiptrace,136579287,0,136579287,2016.csv,2016,0.0,100.0
523,Contagion,136515867,75658097,60857770,2011.csv,2011,55.42073508568788,44.57926491431212
524,The Wind Rises,136454220,5209580,131244640,2012.csv,2012,3.8178225634941887,96.18217743650581
525,Unknown,135710029,63686397,72023632,2011.csv,2011,46.92829076029451,53.07170923970549
526,Jack Ryan: Shadow Recruit,135503748,50577412,84926336,2014.csv,2014,37.32547087922616,62.67452912077383
527,American Made,134866593,51342000,83524593,2017.csv,2017,38.06873063072039,61.931269369279605
528,Last Vegas,134402450,63914167,70488283,2012.csv,2012,47.55431690419334,52.44568309580666
529,Point Break,133718711,28782481,104936230,2015.csv,2015,21.524647362178058,78.47535263782194
530,The Big Short,133440870,70259870,63181000,2015.csv,2015,52.652436993254014,47.347563006745986
531,The Artist,133432856,44671682,88761174,2011.csv,2011,33.478772274798644,66.52122772520136
532,Zero Dark Thirty,132820716,95720716,37100000,2012.csv,2012,72.06761029657453,27.932389703425482
533,A Wrinkle in Time,132675864,100478608,32197256,2018.csv,2018,75.73239394921144,24.267606050788558
534,Ghost Rider: Spirit of Vengeance,132563930,51774002,80789928,2012.csv,2012,39.05587439961987,60.94412560038014
535,The Three Musketeers,132274484,20374484,111900000,2011.csv,2011,15.403185394395491,84.59681460560451
536,2 Guns,131940411,75612460,56327951,2013.csv,2013,57.30803733815867,42.69196266184134
537,The House with a Clock in Its Walls,131457147,68549695,62907452,2018.csv,2018,52.146038891289805,47.8539611087102
538,A Bad Moms Christmas,130560428,72110659,58449769,2017.csv,2017,55.23163496369665,44.768365036303344
539,Cloud Atlas,130482868,27108272,103374596,2012.csv,2012,20.77534960375028,79.22465039624971
540,The Woman in Black,128955898,54333290,74622608,2012.csv,2012,42.13323379749564,57.86676620250436
541,Pan,128388320,35088320,93300000,2015.csv,2015,27.329838103653042,72.67016189634695
542,Blended,127994610,46294610,81700000,2014.csv,2014,36.169187124364065,63.830812875635935
543,Ad Astra,127461872,50188370,77273502,2019.csv,2019,39.3752023350167,60.6247976649833
544,Midway,127420861,56846802,70574059,2019.csv,2019,44.61341852022174,55.386581479778265
545,Chronicle,126636097,64575175,62060922,2012.csv,2012,50.99270786906833,49.007292130931674
546,Walking with Dinosaurs 3D,126546518,36076121,90470397,2012.csv,2012,28.508189375862557,71.49181062413744
547,Sex Tape,126069509,38543473,87526036,2014.csv,2014,30.573191968249837,69.42680803175017
548,This Is the End,126041322,101470202,24571120,2013.csv,2013,80.50550437736602,19.49449562263398
549,The Upside,125852517,108252517,17600000,2019.csv,2019,86.0153770305603,13.984622969439698
550,Detective Chinatown,125842935,474252,125368683,2015.csv,2015,0.3768602504383738,99.62313974956163
551,Wolf Totem,125837070,210591,125626479,2015.csv,2015,0.16735211651065937,99.83264788348934
552,Mechanic: Resurrection,125729635,21218403,104511232,2016.csv,2016,16.87621458536804,83.12378541463195
553,Ender's Game,125544024,61737191,63806833,2013.csv,2013,49.17573057878087,50.82426942121913
554,Happy Death Day,125479266,55683845,69795421,2017.csv,2017,44.37692917330263,55.62307082669737
555,Captain Underpants: The First Epic Movie,125427681,73921000,51506681,2017.csv,2017,58.93515642691345,41.06484357308655
556,Ride Along 2,124605297,91221830,33383467,2015.csv,2015,73.20862932496361,26.79137067503639
557,The Theory of Everything,123726688,35893537,87833151,2014.csv,2014,29.01034334645731,70.98965665354268
558,The Curse of La Llorona,123133739,54733739,68400000,2019.csv,2019,44.45064321485438,55.54935678514562
559,The Lego Ninjago Movie,123081555,59281555,63800000,2017.csv,2017,48.164450798496986,51.835549201503014
560,The Pirates! Band of Misfits,123054041,31051126,92002915,2012.csv,2012,25.233731251458863,74.76626874854114
561,Looking Up,122994583,84267,122910316,2019.csv,2019,0.06851277344466462,99.93148722655533
562,Zombieland: Double Tap,122810399,73123082,49687317,2019.csv,2019,59.54144160056023,40.458558399439774
563,Dragon Blade,122593849,74068,122519781,2015.csv,2015,0.06041738684621934,99.93958261315377
564,Prisoners,122126687,61002302,61124385,2013.csv,2013,49.950017885935125,50.04998211406488
565,Secret Superstar,122026260,0,122026260,2017.csv,2017,0.0,100.0
566,Deepwater Horizon,121790373,61433527,60356846,2016.csv,2016,50.44202221139433,49.557977788605676
567,Last Christmas,121550750,35150750,86400000,2019.csv,2019,28.91857927655732,71.08142072344268
568,The Nut Job,120885527,64251541,56633986,2014.csv,2014,53.150730773585494,46.849269226414506
569,Instant Family,120556201,67363237,53192964,2018.csv,2018,55.87704028596588,44.122959714034124
570,We Bought a Zoo,120081841,75624550,44457291,2011.csv,2011,62.977507148645394,37.022492851354606
571,The Commuter,119942387,36343858,83598529,2017.csv,2017,30.301096142100292,69.69890385789971
572,Extreme Job,119932733,1565885,118366848,2019.csv,2019,1.3056360518358237,98.69436394816418
573,Parental Guidance,119772232,77267296,42504936,2012.csv,2012,64.51186114658029,35.48813885341971
574,Dora and the Lost City of Gold,119682635,60477943,59204692,2019.csv,2019,50.5319280445321,49.46807195546789
575,Wonder Park,119559110,45216793,74342317,2019.csv,2019,37.81961324402632,62.180386755973686
576,Allied,119520023,40098064,79421959,2016.csv,2016,33.54924387857589,66.4507561214241
577,I Belonged to You,119107580,744541,118363039,2016.csv,2016,0.6250995948368693,99.37490040516313
578,The Shallows,119100758,55124043,63976715,2016.csv,2016,46.2835366673317,53.7164633326683
579,Forever Young,119055731,0,119055731,2017.csv,2017,0.0,100.0
580,Hankyu Railways - A 15-minute Miracle,118799256,0,118799256,2011.csv,2011,0.0,100.0
581,The Purge: Election Year,118587880,79213375,39374505,2016.csv,2016,66.79719293405026,33.20280706594974
582,Jurassic Park 2013 Re-release,118192315,45385935,72806380,2013.csv,2013,38.400072796611184,61.599927203388816
583,A Cool Fish,118153135,551876,117601259,2018.csv,2018,0.4670853634141828,99.53291463658582
584,Why Him?,118102725,60323786,57778939,2016.csv,2016,51.07738707976467,48.92261292023533
585,P Storm,117991727,326711,117665016,2019.csv,2019,0.27689314183866465,99.72310685816133
586,Saving Mr. Banks,117867984,83301580,34566404,2013.csv,2013,70.67362753909492,29.326372460905077
587,Pompeii,117831631,23219748,94611883,2014.csv,2014,19.705869979852864,80.29413002014714
588,Magic Mike XXL,117813057,66013057,51800000,2015.csv,2015,56.03203811271954,43.96796188728045
589,Game Night,117679066,69179066,48500000,2018.csv,2018,58.78621266419637,41.21378733580364
590,Water for Elephants,117094902,58709717,58385185,2011.csv,2011,50.13857648559286,49.86142351440714
591,Warm Bodies,116980662,66380662,50600000,2013.csv,2013,56.74498747493838,43.25501252506162
592,Abraham Lincoln: Vampire Hunter,116471580,37519139,78952441,2012.csv,2012,32.21312787205257,67.78687212794743
593,Personal Tailor,116126458,375892,115750566,2013.csv,2013,0.3236919531292343,99.67630804687076
594,The Iron Lady,115890699,30017992,85872707,2011.csv,2011,25.901985456140874,74.09801454385912
595,Dragon Ball Super: Broly,115757940,30712119,85045821,2018.csv,2018,26.531328218176654,73.46867178182335
596,Detective Conan: The Fist of Blue Sapphire,115570314,0,115570314,2019.csv,2019,0.0,100.0
597,Pitch Perfect,115350426,65001093,50349333,2012.csv,2012,56.35097784554346,43.64902215445654
598,The Gentlemen,115171795,36471795,78700000,2019.csv,2019,31.667297535824634,68.33270246417537
599,The Monkey King 3,115084576,187074,114897502,2018.csv,2018,0.16255349457081025,99.8374465054292
600,So Young,114926694,11186,114915508,2013.csv,2013,0.009733160861653255,99.99026683913834
601,Book of Love,114679097,0,114679097,2016.csv,2016,0.0,100.0
602,Office Christmas Party,114501299,54767494,59733805,2016.csv,2016,47.83132984369025,52.16867015630976
603,Hope Springs,114281051,63536011,50745040,2012.csv,2012,55.59627816163504,44.40372183836496
604,Seventh Son,114178613,17223265,96955348,2014.csv,2014,15.084493100297165,84.91550689970285
605,The Dark Tower,113231078,50701325,62529753,2017.csv,2017,44.776863291895886,55.223136708104114
606,Pet Sematary,113118226,54724696,58393530,2019.csv,2019,48.378318804257056,51.621681195742944
607,Insidious: Chapter 3,112983889,52218558,60765331,2015.csv,2015,46.21770277353438,53.78229722646562
608,Boonie Bears: Blast Into the Past,112367881,0,112367881,2019.csv,2019,0.0,100.0
609,How to Be Single,112343513,46843513,65500000,2016.csv,2016,41.69667811616324,58.303321883836766
610,The Purge: Anarchy,111928365,71962800,39965565,2014.csv,2014,64.2936220858761,35.70637791412391
611,"Dad, Where Are We Going?",111870000,0,111870000,2014.csv,2014,0.0,100.0
612,Get Hard,111711453,90411453,21300000,2015.csv,2015,80.9330203591569,19.066979640843094
613,Good Boys,111037232,83140306,27896926,2019.csv,2019,74.8760613917321,25.1239386082679
614,Free Birds,110387072,55750480,54636592,2013.csv,2013,50.50453734292364,49.49546265707637
615,10 Cloverfield Lane,110216998,72082998,38134000,2016.csv,2016,65.40098107190326,34.59901892809674
616,Moneyball,110206216,75605492,34600724,2011.csv,2011,68.6036548065492,31.39634519345079
617,Buddies in India,110155128,293194,109861934,2017.csv,2017,0.2661646401064506,99.73383535989355
618,The 5th Wave,109906372,34916787,74989585,2015.csv,2015,31.76957474312772,68.23042525687228
619,Along With the Gods: The Two Worlds,109383972,1908823,107475149,2017.csv,2017,1.7450664526974757,98.25493354730253
620,The Boxtrolls,108255770,50837305,57418465,2014.csv,2014,46.960365253510275,53.039634746489725
621,Neighbors 2: Sorority Rising,108007109,55455765,52551344,2016.csv,2016,51.34455084803723,48.65544915196276
622,Horrible Bosses 2,107645357,54445357,53200000,2014.csv,2014,50.578453653138055,49.421546346861945
623,Paul Blart: Mall Cop 2,107588225,71038190,36550035,2015.csv,2015,66.0278483077493,33.972151692250705
624,Vacation,107228221,58884188,48344033,2015.csv,2015,54.91482321617552,45.08517678382448
625,ParaNorman,107139399,56003051,51136348,2012.csv,2012,52.27120137196215,47.72879862803785
626,The Man from U.N.C.L.E.,107045109,45445109,61600000,2015.csv,2015,42.4541666821975,57.5458333178025
627,The Breakup Guru,106980263,208959,106771304,2014.csv,2014,0.19532481426036502,99.80467518573963
628,Chronicles of the Ghostly Tribe,106380000,0,106380000,2015.csv,2015,0.0,100.0
629,Shaun the Sheep Movie,106209378,19375982,86833396,2015.csv,2015,18.243193176406702,81.7568068235933
630,First Man,105697415,44936545,60760870,2018.csv,2018,42.51432733714443,57.48567266285557
631,Gangster Squad,105200903,46000903,59200000,2013.csv,2013,43.72671877160598,56.273281228394026
632,Sisters,105011053,87044645,17966408,2015.csv,2015,82.89093625220576,17.109063747794245
633,The Campaign,104907746,86907746,18000000,2012.csv,2012,82.84206773444545,17.15793226555454
634,Scary Stories to Tell in the Dark,104545505,68947075,35598430,2019.csv,2019,65.94934425922952,34.050655740770495
635,Book Club,104438188,68566296,35871892,2018.csv,2018,65.65251400187066,34.34748599812934
636,Immortal Demon Slayer,103818506,0,103818506,2017.csv,2017,0.0,100.0
637,Ouija,103590271,50856010,52734261,2014.csv,2014,49.09342306865864,50.90657693134136
638,Birdman or (The Unexpected Virtue of Ignorance),103215094,42340598,60874496,2014.csv,2014,41.02171141751806,58.978288582481945
639,Cold War 2,103197501,560824,102636677,2016.csv,2016,0.5434472681659219,99.45655273183408
640,Night School,103105878,77339130,25766748,2018.csv,2018,75.009428657404,24.990571342596006
641,Transcendence,103039258,23022309,80016949,2014.csv,2014,22.343240282262126,77.65675971773788
642,Jigsaw,102952888,38052832,64900056,2017.csv,2017,36.96140316141496,63.03859683858505
643,Chappie,102811889,31569268,71242621,2015.csv,2015,30.705853483540217,69.29414651645979
644,Star Wars: Episode I - The Phantom Menace 2012 3D Release,102739593,43456382,59283211,2012.csv,2012,42.29759991359903,57.702400086400964
645,Project X,102731865,54731865,48000000,2012.csv,2012,53.27642499238186,46.72357500761814
646,Railroad Tigers,102205175,218044,101987131,2016.csv,2016,0.2133394908819441,99.78666050911805
647,Heaven Is for Real,101888019,91443253,10444766,2014.csv,2014,89.74877900020806,10.251220999791938
648,Detective Conan: Zero the Enforcer,101860359,0,101860359,2018.csv,2018,0.0,100.0
649,The Devil Inside,101758490,53261944,48496546,2012.csv,2012,52.34152354265477,47.65847645734523
650,Joy,101134059,56451232,44682827,2015.csv,2015,55.81822044737669,44.18177955262332
651,"Alexander and the Terrible, Horrible, No Good, Very Bad Day",100654149,66954149,33700000,2014.csv,2014,66.5190155251325,33.4809844748675
652,Life,100541806,30234022,70307784,2017.csv,2017,30.071095003008004,69.928904996992
653,Instructions Not Included,100486616,44467206,56019410,2013.csv,2013,44.25186932357241,55.7481306764276
654,Tammy,100375432,84525432,15850000,2014.csv,2014,84.20928340313395,15.790716596866053
655,PK,100370104,10616104,89754000,2014.csv,2014,10.576958254422054,89.42304174557795
656,Philomena,100129872,37709979,62419893,2013.csv,2013,37.6610678180034,62.3389321819966
657,The Continent,100125957,0,100125957,2014.csv,2014,0.0,100.0
658,Atomic Blonde,100014025,51687870,48326155,2017.csv,2017,51.68062179279356,48.319378207206434
659,The Book of Life,99783556,50151543,49632013,2014.csv,2014,50.26032846534353,49.73967153465647
660,Black Mass,99775678,62575678,37200000,2015.csv,2015,62.71636460340565,37.28363539659435
661,Insidious,99557032,54009150,45547882,2011.csv,2011,54.24945773795265,45.75054226204735
662,Line Walker 2: Invisible Spy,99482027,296751,99185276,2019.csv,2019,0.2982960932229497,99.70170390677706
663,The Lucky One,99357138,60457138,38900000,2012.csv,2012,60.848308653979146,39.151691346020854
664,Blue Jasmine,99104804,33405481,65699323,2013.csv,2013,33.70722674553698,66.29277325446303
665,Ode to My Father,99085291,2300121,96785170,2014.csv,2014,2.3213546398122804,97.67864536018772
666,Justin Bieber: Never Say Never,99036827,73013910,26022917,2011.csv,2011,73.72399965923788,26.276000340762128
667,Young Detective Dee: Rise of the Sea Dragon,98774891,87783,98687108,2013.csv,2013,0.08887177612780155,99.9111282238722
668,Spotlight,98690254,45055776,53634478,2015.csv,2015,45.653723821604515,54.34627617839549
669,Devil and Angel,98599942,131058,98468884,2015.csv,2015,0.1329189422849762,99.86708105771503
670,The Visit,98450062,65206105,33243957,2015.csv,2015,66.2326703257942,33.76732967420579
671,Riddick,98337295,42025135,56312160,2013.csv,2013,42.735703681904205,57.264296318095795
672,Alpha,98203196,35857181,62346015,2018.csv,2018,36.513252582940375,63.48674741705962
673,Paul,97984015,37412945,60571070,2011.csv,2011,38.18270255612612,61.817297443873876
674,Along With the Gods: The Last 49 Days,97962238,1200246,96761992,2018.csv,2018,1.2252129233715547,98.77478707662844
675,A Simple Favor,97644617,53548586,44096031,2018.csv,2018,54.84028474401206,45.15971525598795
676,Safe Haven,97594140,71349120,26245020,2013.csv,2013,73.1079960333684,26.892003966631606
677,The Little Prince,97571250,1339152,96232098,2015.csv,2015,1.3724862600407395,98.62751373995926
678,Evil Dead,97542952,54239856,43303096,2013.csv,2013,55.60612518677925,44.39387481322075
679,42,97470701,95020213,2450488,2013.csv,2013,97.48592348792074,2.5140765120792556
680,Scream 4,97138686,38180928,58957758,2011.csv,2011,39.305584183010254,60.694415816989746
681,Legend of the Demon Cat,97051623,0,97051623,2017.csv,2017,0.0,100.0
682,The Shack,96942115,57386418,39555697,2017.csv,2017,59.19658138261168,40.803418617388324
683,Boonie Bears: The Big Shrink,96845907,0,96845907,2018.csv,2018,0.0,100.0
684,The Rite,96560591,33047633,63512958,2011.csv,2011,34.22476256384967,65.77523743615032
685,Contraband,96262212,66528000,29734212,2012.csv,2012,69.11123131057907,30.88876868942093
686,Assassination,96119773,1904682,94215091,2015.csv,2015,1.9815714712518098,98.01842852874819
687,Think Like a Man,96070507,91547205,4523302,2012.csv,2012,95.29168509540602,4.708314904593977
688,Dolphin Tale,95932565,72286779,23645786,2011.csv,2011,75.35165874069978,24.648341259300217
689,The Favourite,95918706,34366783,61551923,2018.csv,2018,35.82907279837574,64.17092720162427
690,Qing sheng,95721752,100026,95621726,2016.csv,2016,0.10449662475881134,99.89550337524119
691,The New King of Comedy,95618308,0,95618308,2019.csv,2019,0.0,100.0
692,Poltergeist,95437994,47425125,48012869,2015.csv,2015,49.69208070320506,50.30791929679494
693,The Mortal Instruments: City of Bones,95396573,31165421,64231152,2013.csv,2013,32.669329746258285,67.33067025374172
694,Truth or Dare,95330493,41411015,53919478,2018.csv,2018,43.43942184375361,56.5605781562464
695,Rush,95224595,26947624,68276971,2013.csv,2013,28.29901665635858,71.70098334364143
696,The Hustle,95017038,35417038,59600000,2019.csv,2019,37.27440756467277,62.72559243532723
697,Adoring,94975692,0,94975692,2019.csv,2019,0.0,100.0
698,Kill Mobile,94870905,0,94870905,2018.csv,2018,0.0,100.0
699,I Feel Pretty,94539426,48795601,45743825,2018.csv,2018,51.61402291568811,48.38597708431189
700,Veteran,94393020,1200627,93192393,2015.csv,2015,1.271944684045494,98.7280553159545
701,Masquerade,94268432,922921,93345511,2012.csv,2012,0.9790350602203716,99.02096493977963
702,Police Story: Lockdown,94249025,0,94249025,2013.csv,2013,0.0,100.0
703,Fleet of Time,94244191,569280,93674911,2014.csv,2014,0.6040478399353016,99.3959521600647
704,Dirty Grandpa,94073028,35593113,58479915,2016.csv,2016,37.8356195784407,62.16438042155931
705,Ben-Hur,94061311,26410477,67650834,2016.csv,2016,28.077938441661736,71.92206155833827
706,Blockers,94017294,60311495,33705799,2018.csv,2018,64.14936277574634,35.85063722425366
707,In the Heart of the Sea,93920758,25020758,68900000,2015.csv,2015,26.640285420183684,73.35971457981631
708,The Man from Macau,93864936,0,93864936,2014.csv,2014,0.0,100.0
709,Rien à déclarer,93811164,0,93811164,2011.csv,2011,0.0,100.0
710,Kill Zone 2,93638358,11998,93626360,2015.csv,2015,0.012813125151126635,99.98718687484887
711,The Internship,93492844,44672764,48820080,2013.csv,2013,47.782014204210114,52.217985795789886
712,BlacKkKlansman,93400823,49275340,44125483,2018.csv,2018,52.75685847008008,47.243141529919924
713,Goosebumps 2: Haunted Halloween,93320380,46700633,46619747,2018.csv,2018,50.04333780038187,49.95666219961814
714,Money Monster,93282604,41012075,52270529,2016.csv,2016,43.96540538255129,56.03459461744872
715,Train to Busan,92742323,2129768,90612555,2016.csv,2016,2.2964359001445325,97.70356409985547
716,Southpaw,91970827,52421953,39548874,2015.csv,2015,56.99845778270538,43.00154221729462
717,Brave Hearts: Umizaru,91884352,0,91884352,2012.csv,2012,0.0,100.0
718,Shadow,91708374,521396,91186978,2018.csv,2018,0.5685369582498541,99.43146304175015
719,Season of the Witch,91627228,24827228,66800000,2011.csv,2011,27.09590647007241,72.9040935299276
720,Crawl,91542097,39014193,52527904,2019.csv,2019,42.61885436161682,57.38114563838318
721,Five Feet Apart,91522094,45729221,45792873,2019.csv,2019,49.965225883052895,50.0347741169471
722,Rambo: Last Blood,91490353,44819352,46671001,2019.csv,2019,48.988063255149974,51.011936744850026
723,Overboard,91244913,50316123,40928790,2018.csv,2018,55.1440308787406,44.8559691212594
724,Paranormal Activity: The Marked Ones,90894962,32462372,58432590,2014.csv,2014,35.71415982329141,64.28584017670859
725,My Big Fat Greek Wedding 2,90632641,59689605,30943036,2016.csv,2016,65.85883887020351,34.141161129796494
726,Sherlock Gnomes,90497778,43242871,47254907,2018.csv,2018,47.78335110062039,52.21664889937961
727,Jojo Rabbit,90335025,33370906,56964119,2019.csv,2019,36.941270564767095,63.0587294352329
728,Red Riding Hood,90260376,37662162,52598214,2011.csv,2011,41.72613019028416,58.27386980971584
729,Detective Dee: The Four Heavenly Kings,90040771,262963,89777808,2018.csv,2018,0.29204880975530517,99.7079511902447
730,Sucker Punch,89792502,36392502,53400000,2011.csv,2011,40.52955557469598,59.47044442530402
731,The Hundred-Foot Journey,89514453,54240821,35273632,2014.csv,2014,60.594484110850786,39.40551588914921
732,The Purge,89328627,64473115,24855512,2013.csv,2013,72.17519978226017,27.82480021773983
733,The Inbetweeners,88823111,36000,88787111,2011.csv,2011,0.040529992244923735,99.95947000775509
734,Collateral Beauty,88528280,31016021,57512259,2016.csv,2016,35.0351559976089,64.9648440023911
735,Line Walker,88228755,0,88228755,2016.csv,2016,0.0,100.0
736,This Is 40,88215156,67544505,20670651,2012.csv,2012,76.56791424820469,23.432085751795302
737,Dhoom 3,88031955,8031955,80000000,2013.csv,2013,9.123908471645324,90.87609152835468
738,Chasing the Dragon,87965942,456854,87509088,2017.csv,2017,0.5193532742478902,99.48064672575211
739,Deliver Us from Evil,87937815,30577122,57360693,2014.csv,2014,34.77130060600209,65.2286993939979
740,Tiger Zinda Hai,87320000,5560921,81759079,2017.csv,2017,6.368439074667888,93.63156092533211
741,Pain & Gain,87305549,49875291,37430258,2013.csv,2013,57.12728637672274,42.87271362327726
742,Sultan,87280000,6200000,81080000,2016.csv,2016,7.1035747021081574,92.89642529789184
743,A Million Ways to Die in the West,87189756,43139300,44050456,2014.csv,2014,49.477486781818726,50.522513218181274
744,The Thieves,87126367,685839,86440528,2012.csv,2012,0.7871773191231536,99.21282268087684
745,About Time,87100449,15322921,71777528,2013.csv,2013,17.592241114623874,82.40775888537613
746,American Dreams in China,87097067,0,87097067,2013.csv,2013,0.0,100.0
747,"Hello, Mrs. Money",86874070,0,86874070,2018.csv,2018,0.0,100.0
748,Snowpiercer,86758912,4563650,82195262,2013.csv,2013,5.260151256853014,94.73984874314698
749,The Lincoln Lawyer,86752352,58009200,28743152,2011.csv,2011,66.86758187259292,33.13241812740708
750,Robin Hood,86489031,30824628,55664403,2018.csv,2018,35.63992756491861,64.36007243508139
751,A Taxi Driver,86252940,1527829,84725111,2017.csv,2017,1.7713355625906781,98.22866443740932
752,War Dogs,86234523,43034523,43200000,2016.csv,2016,49.90405408747956,50.09594591252045
753,Step Up All In,86165646,14904384,71261262,2014.csv,2014,17.297362338582133,82.70263766141787
754,Hall Pass,86157237,45060734,41096503,2011.csv,2011,52.300579230506195,47.699420769493805
755,I Can Only Imagine,86086881,83482352,2604529,2018.csv,2018,96.97453436604353,3.025465633956468
756,John Wick,86013056,43037835,42975221,2014.csv,2014,50.03639796265348,49.96360203734652
757,The Second Best Exotic Marigold Hotel,85978266,33078266,52900000,2015.csv,2015,38.472822887588826,61.52717711241118
758,Spy Kids 4-D: All the Time in the World,85564310,38538188,47026122,2011.csv,2011,45.04002661857496,54.95997338142503
759,Paper Towns,85512300,32000304,53511996,2015.csv,2015,37.42187264288295,62.57812735711704
760,The Possession,85446075,49130154,36315921,2012.csv,2012,57.49843278348362,42.501567216516385
761,Big Fish & Begonia,85409373,0,85409373,2016.csv,2016,0.0,100.0
762,Nerve,85251425,38583626,46667799,2016.csv,2016,45.25862881470896,54.74137118529103
763,Hidden Man,85170581,0,85170581,2018.csv,2018,0.0,100.0
764,J. Edgar,84920539,37306030,47614509,2011.csv,2011,43.93051485459837,56.06948514540163
765,Going in Style,84918541,45018541,39900000,2017.csv,2017,53.01379471416025,46.98620528583975
766,Sicario,84872444,46889293,37983151,2015.csv,2015,55.24678068655593,44.75321931344406
767,Carrie,84790678,35266619,49524059,2013.csv,2013,41.59256634320108,58.40743365679892
768,The Judge,84419388,47119388,37300000,2014.csv,2014,55.81583699706517,44.184163002934824
769,What to Expect When You're Expecting,84384002,41152203,43231799,2012.csv,2012,48.76777828100639,51.23222171899361
770,Leap!,84197417,2844490,81352927,2016.csv,2016,3.37835779451524,96.62164220548476
771,Finding Mr. Right,84112033,6945,84105088,2013.csv,2013,0.008256844772733052,99.99174315522727
772,Our Times,83867493,0,83867493,2015.csv,2015,0.0,100.0
773,Mortal Engines,83672673,15951040,67721633,2018.csv,2018,19.063619492591087,80.93638050740891
774,Rings,83080890,27793018,55287872,2017.csv,2017,33.45296132480045,66.54703867519956
775,Suck Me Shakespeer 2,83027924,0,83027924,2015.csv,2015,0.0,100.0
776,Savages,82966152,47382068,35584084,2012.csv,2012,57.110118834967786,42.889881165032214
777,Once Upon A Time,82886178,485728,82400450,2017.csv,2017,0.5860180933906736,99.41398190660932
778,The Fighter Pilot,82879386,0,82879386,2013.csv,2013,0.0,100.0
779,"Big Mommas: Like Father, Like Son",82686066,37915414,44770652,2011.csv,2011,45.85465947793429,54.14534052206571
780,Sinister,82515113,48086903,34428210,2012.csv,2012,58.27647960683275,41.72352039316725
781,Act of Valor,82497035,70012847,12484188,2012.csv,2012,84.86710704208946,15.13289295791055
782,Hitman: Agent 47,82347656,22467450,59880206,2015.csv,2015,27.28365455842483,72.71634544157517
783,Tiny Times 3.0,82320000,0,82320000,2014.csv,2014,0.0,100.0
784,Miracle in Cell No. 7,82101723,0,82101723,2013.csv,2013,0.0,100.0
785,Abduction,82087155,28087155,54000000,2011.csv,2011,34.21626075358562,65.78373924641437
786,Ouija: Origin of Evil,81705746,35144505,46561241,2016.csv,2016,43.013504827432826,56.986495172567174
787,One Piece: Stampede,81562741,1298528,80264213,2019.csv,2019,1.592060276640286,98.40793972335972
788,Frankenweenie,81491068,35291068,46200000,2012.csv,2012,43.30667012487798,56.693329875122025
789,Wolf Warrior,81411331,0,81411331,2015.csv,2015,0.0,100.0
790,Gone with the Bullets,81387479,0,81387479,2014.csv,2014,0.0,100.0
791,Tinker Tailor Soldier Spy,81244605,24149393,57095212,2011.csv,2011,29.7243035399089,70.27569646009111
792,iPartment the Movie,81096321,0,81096321,2018.csv,2018,0.0,100.0
793,Underworld: Blood Wars,81093313,30353973,50739340,2016.csv,2016,37.430919858953104,62.569080141046896
794,Doraemon the Movie: Nobita's Treasure Island,80920916,0,80920916,2018.csv,2018,0.0,100.0
795,A Dog's Way Home,80708134,42004346,38703788,2019.csv,2019,52.044749293794844,47.95525070620515
796,Go Away Mr. Tumor,80606893,286639,80320254,2015.csv,2015,0.3556011022531287,99.64439889774687
797,Den of Thieves,80509622,44947622,35562000,2018.csv,2018,55.828882167649475,44.171117832350525
798,Muppets Most Wanted,80383113,51183113,29200000,2014.csv,2014,63.673962216417266,36.32603778358273
799,Hereditary,80200936,44069456,36131480,2018.csv,2018,54.94880508626483,45.05119491373517
800,The Wedding Ringer,79799880,64460211,15339669,2015.csv,2015,80.77732823658381,19.222671763416184
801,The Grey,79781695,51580236,28201459,2012.csv,2012,64.65171741462751,35.348282585372495
802,Paradox,79226860,0,79226860,2017.csv,2017,0.0,100.0
803,Manchester by the Sea,78988148,47695371,31292777,2016.csv,2016,60.382946312401195,39.617053687598805
804,Lady Bird,78965611,48958273,30007338,2017.csv,2017,61.99948608008617,38.00051391991382
805,Paranormal Activity: The Ghost Dimension,78903124,18300124,60603000,2015.csv,2015,23.193155191168348,76.80684480883166
806,The Boss,78844582,63285885,15558697,2016.csv,2016,80.26662504216206,19.733374957837942
807,Code Blue: The Movie,78778562,0,78778562,2018.csv,2018,0.0,100.0
808,Spanish Affair,78768613,0,78768613,2014.csv,2014,0.0,100.0
809,The Attorney,78547586,557236,77990350,2013.csv,2013,0.7094247301247424,99.29057526987526
810,The Family,78418811,36918811,41500000,2013.csv,2013,47.07902418974447,52.92097581025552
811,Scary Movie V,78378744,32015787,46362957,2013.csv,2013,40.84753769465864,59.15246230534136
812,R.I.P.D.,78324220,33618855,44705365,2013.csv,2013,42.92268087700075,57.07731912299925
813,Priest,78309505,29137000,49172505,2011.csv,2011,37.20748841408204,62.79251158591796
814,If I Stay,78274843,50474843,27800000,2014.csv,2014,64.4841191185781,35.51588088142189
815,Tag,78130625,54730625,23400000,2018.csv,2018,70.05015638874002,29.94984361125999
816,Head Full of Honey,78127384,0,78127384,2014.csv,2014,0.0,100.0
817,The Left Ear,78015473,0,78015473,2015.csv,2015,0.0,100.0
818,Shin Godzilla,77947607,1918403,76029204,2016.csv,2016,2.461144188813904,97.5388558111861
819,Tiny Times 4.0,77750000,0,77750000,2015.csv,2015,0.0,100.0
820,Tiny Times,77717014,23462,77693552,2013.csv,2013,0.030189013695250823,99.96981098630475
821,Suck Me Shakespeer,77676735,0,77676735,2013.csv,2013,0.0,100.0
822,Diary of a Wimpy Kid: Dog Days,77229695,49008662,28221033,2012.csv,2012,63.45831354118386,36.54168645881613
823,Fantastica: A Boonie Bears Adventure,77151096,0,77151096,2017.csv,2017,0.0,100.0
824,Mike and Dave Need Wedding Dates,77068246,46009673,31058573,2016.csv,2016,59.699909350473604,40.300090649526396
825,Drive,76976666,35061555,41915111,2011.csv,2011,45.5482899194413,54.451710080558705
826,"I, Frankenstein",76801179,19075290,57725889,2014.csv,2014,24.8372358971208,75.1627641028792
827,Sanju,76693052,7909317,68783735,2018.csv,2018,10.312951165380666,89.68704883461933
828,The Book Thief,76586316,21488481,55097835,2013.csv,2013,28.057859578987976,71.94214042101203
829,Cold Pursuit,76419755,32138862,44280893,2019.csv,2019,42.055698817668286,57.944301182331714
830,The Ides of March,76338111,40962534,35375577,2011.csv,2011,53.65934978401549,46.34065021598452
831,Kubo and the Two Strings,76249438,48023088,28226350,2016.csv,2016,62.981563221488926,37.018436778511074
832,The Mechanic,76130093,29121498,47008595,2011.csv,2011,38.25228218229025,61.74771781770975
833,Vice,76073488,47836282,28237206,2018.csv,2018,62.88167304751426,37.11832695248573
834,Widows,75984700,42402632,33582068,2018.csv,2018,55.80417110286676,44.19582889713324
835,Quo vado?,75878701,0,75878701,2016.csv,2016,0.0,100.0
836,Sicario: Day of the Soldado,75837743,50072235,25765508,2018.csv,2018,66.02548153364744,33.97451846635256
837,A Dog's Journey,75741734,22782371,52959363,2019.csv,2019,30.079019579879173,69.92098042012083
838,Bajrangi Bhaijaan,75547184,8178001,67369183,2015.csv,2015,10.825024265629809,89.1749757343702
839,Searching,75462037,26020957,49441080,2018.csv,2018,34.48218208050758,65.51781791949242
840,The Change-Up,75450437,37081475,38368962,2011.csv,2011,49.14679950760259,50.85320049239741
841,The Spy Who Dumped Me,75320680,33562069,41758611,2018.csv,2018,44.55890334500432,55.44109665499568
842,Larry Crowne,75055070,35608245,39446825,2011.csv,2011,47.44282431553258,52.55717568446742
843,Animal World,74922830,0,74922830,2018.csv,2018,0.0,100.0
844,Boo! A Madea Halloween,74827344,73206343,1621001,2016.csv,2016,97.8336782874453,2.1663217125547045
845,A Madea Family Funeral,74747725,73257045,1490680,2019.csv,2019,98.00571856869223,1.9942814313077755
846,Crimson Peak,74679822,31090320,43589502,2014.csv,2014,41.63148648104705,58.368513518952945
847,Escape from Planet Earth,74597643,57012977,17584666,2013.csv,2013,76.42731687916735,23.572683120832654
848,Thermae Romae,74285251,0,74285251,2012.csv,2012,0.0,100.0
849,One Piece Film Z,74223861,0,74223861,2012.csv,2012,0.0,100.0
850,August: Osage County,74188937,37738810,36450127,2013.csv,2013,50.86851426379111,49.13148573620889
851,Miracles from Heaven,73983003,61705123,12277880,2016.csv,2016,83.40445845378837,16.595541546211635
852,Cats,73833348,27166770,46666578,2019.csv,2019,36.794715038521616,63.205284961478384
853,Charlie's Angels,73279888,17803077,55476811,2019.csv,2019,24.294629107511735,75.70537089248826
854,War Room,73267874,67790117,5477757,2015.csv,2015,92.52365777666758,7.476342223332426
855,To Rome with Love,73244881,16685867,56559014,2012.csv,2012,22.780932636097805,77.2190673639022
856,Here Comes the Boom,73100172,45290318,27809854,2012.csv,2012,61.95651359069305,38.043486409306944
857,My Old Classmate,73052128,0,73052128,2014.csv,2014,0.0,100.0
858,Bayside Shakedown the Final,72867395,0,72867395,2012.csv,2012,0.0,100.0
859,The Best Man Holiday,72835710,70525195,2310515,2013.csv,2013,96.82777170703766,3.1722282929623398
860,The Bélier Family,72751538,0,72751538,2014.csv,2014,0.0,100.0
861,The Transporter Refueled,72629670,16029670,56600000,2015.csv,2015,22.070415575342693,77.9295844246573
862,Diary of a Wimpy Kid: Rodrick Rules,72526996,52698535,19828461,2011.csv,2011,72.66057868989914,27.339421310100864
863,Amazing China,72506343,0,72506343,2018.csv,2018,0.0,100.0
864,Serial (Bad) Weddings 2,72488125,0,72488125,2019.csv,2019,0.0,100.0
865,Doctor Sleep,72381712,31581712,40800000,2019.csv,2019,43.63217051290525,56.36782948709475
866,Second Act,72282227,39282227,33000000,2018.csv,2018,54.345623579085355,45.654376420914645
867,What Men Want,72216294,54611903,17604391,2019.csv,2019,75.62268841987377,24.377311580126225
868,Run All Night,71561644,26461644,45100000,2015.csv,2015,36.97741208963841,63.022587910361594
869,Brick Mansions,71416730,20396829,51019901,2014.csv,2014,28.560295325759107,71.4397046742409
870,The Counselor,71009334,16973715,54035619,2013.csv,2013,23.903498376706363,76.09650162329363
871,Son of God,70829270,59700064,11129206,2014.csv,2014,84.2872784090532,15.712721590946794
872,I Am Not Madame Bovary,70826207,436798,70389409,2016.csv,2016,0.6167180461887505,99.38328195381125
873,Spirited Away 2018 Re-release,70186029,1175067,69010962,2018.csv,2018,1.6742178133485794,98.32578218665142
874,Think Like a Man Too,70181428,65182182,4999246,2014.csv,2014,92.8766824180323,7.123317581967696
875,See You Tomorrow,70065569,0,70065569,2016.csv,2016,0.0,100.0
876,The Cabin in the Woods,69935600,42073277,27862323,2012.csv,2012,60.160028654933974,39.83997134506603
877,Sole a catinelle,69903094,0,69903094,2013.csv,2013,0.0,100.0
878,The Dilemma,69721966,48475290,21246676,2011.csv,2011,69.52656785380952,30.473432146190483
879,After,69518232,12138565,57379667,2019.csv,2019,17.46098059570905,82.53901940429095
880,Exit,69501772,470699,69031073,2019.csv,2019,0.6772474808268197,99.32275251917318
881,Playing with Fire,69412425,44451847,24960578,2019.csv,2019,64.04018732957391,35.959812670426075
882,13 Hours,69411370,52853219,16558151,2015.csv,2015,76.14490104431017,23.855098955689826
883,Finding Nemo 2012 3D Release,69328283,41128283,28200000,2012.csv,2012,59.32396017942634,40.67603982057366
884,Anna Karenina,68929150,12816367,56112783,2012.csv,2012,18.593536986891614,81.4064630131084
885,Running Man,68782475,310978,68471497,2015.csv,2015,0.4521180722269735,99.54788192777303
886,The Nut Job 2: Nutty by Nature,68743485,28370522,40372963,2017.csv,2017,41.270124725273966,58.72987527472603
887,The Call,68572631,51872378,16700253,2013.csv,2013,75.64589143444124,24.354108565558757
888,One Direction: This Is Us,68532898,28873374,39659524,2013.csv,2013,42.13067715303678,57.86932284696322
889,Stalingrad,68316452,1013945,67302507,2013.csv,2013,1.4841886109659208,98.51581138903408
890,The Watch,68267862,35353000,32914862,2012.csv,2012,51.78571433802922,48.21428566197078
891,Moonrise Kingdom,68263166,45512466,22750700,2012.csv,2012,66.67207026407185,33.32792973592816
892,Shoplifters,67999335,3313513,64685822,2018.csv,2018,4.872860889007223,95.12713911099277
893,A Beautiful Day in the Neighborhood,67925733,61704055,6221678,2019.csv,2019,90.84046984078921,9.159530159210796
894,Jersey Boys,67647013,47047013,20600000,2014.csv,2014,69.54780545890475,30.452194541095256
895,The Secret of the Gods,67537798,0,67537798,2012.csv,2012,0.0,100.0
896,12 Strong,67450815,45819713,21631102,2018.csv,2018,67.93055502739293,32.06944497260707
897,American Assassin,67234188,36249674,30984514,2017.csv,2017,53.915537732083564,46.084462267916436
898,War,67179155,4654000,62525155,2019.csv,2019,6.927744178979328,93.07225582102068
899,The Giver,66980456,45090374,21890082,2014.csv,2014,67.31870263767688,32.68129736232312
900,Madea's Witness Protection,66899242,65653242,1246000,2012.csv,2012,98.13749758181116,1.8625024181888339
901,Selma,66787908,52076908,14711000,2014.csv,2014,77.9735577284439,22.0264422715561
902,A Violent Prosecutor,66736633,0,66736633,2015.csv,2015,0.0,100.0
903,Victoria & Abdul,66558465,22245070,44313395,2017.csv,2017,33.42184949728033,66.57815050271968
904,"Love, Simon",66316289,40826341,25489948,2018.csv,2018,61.563066353124796,38.436933646875204
905,Mile 22,66308758,36108758,30200000,2018.csv,2018,54.45548836851989,45.54451163148011
906,One Piece Film: Gold,66207073,423593,65783480,2016.csv,2016,0.639800221949096,99.36019977805091
907,Life of the Party,65859911,53059911,12800000,2018.csv,2018,80.56480823364612,19.435191766353892
908,Beijing Love Story,65842375,428318,65414057,2014.csv,2014,0.6505202766455493,99.34947972335445
909,The Age of Adaline,65663276,42629776,23033500,2015.csv,2015,64.92179281460157,35.078207185398426
910,Eiga Doraemon: Nobita no getsumen tansaki,65406606,0,65406606,2019.csv,2019,0.0,100.0
911,Moonlight,65336603,27854932,37481671,2016.csv,2016,42.63296639404409,57.36703360595592
912,The House That Never Dies,65220000,0,65220000,2014.csv,2014,0.0,100.0
913,Something Borrowed,65100369,39046489,26053880,2011.csv,2011,59.97890580312993,40.02109419687007
914,The Pirates,64858224,415775,64442449,2014.csv,2014,0.6410520892462304,99.35894791075377
915,God's Not Dead,64667874,60755732,3912142,2014.csv,2014,93.95040882277961,6.0495911772203925
916,The Darkest Hour,64626786,21443494,43183292,2011.csv,2011,33.18050506178661,66.81949493821338
917,Happy Death Day 2U,64600152,28148130,36452022,2019.csv,2019,43.57285413198409,56.42714586801591
918,L Storm,64517456,0,64517456,2018.csv,2018,0.0,100.0
919,Monster Trucks,64493915,33370166,31123749,2016.csv,2016,51.74157282900255,48.25842717099745
920,Monk Comes Down the Mountain,64455686,0,64455686,2015.csv,2015,0.0,100.0
921,Capernaum,64417003,1661096,62755907,2018.csv,2018,2.5786607923997953,97.4213392076002
922,Fences,64414761,57682904,6731857,2016.csv,2016,89.54920130806664,10.45079869193336
923,Zhongkui: Snow Girl and the Dark Crystal,64325947,165428,64160519,2015.csv,2015,0.2571714956641058,99.74282850433589
924,Isle of Dogs,64241499,32015231,32226268,2018.csv,2018,49.83574713908839,50.16425286091161
925,Suck Me Shakespeer 3,64236772,0,64236772,2017.csv,2017,0.0,100.0
926,Thunder and the House of Magic,64197205,4091,64193114,2013.csv,2013,0.00637255157759594,99.9936274484224
927,The Danish Girl,64191523,11114018,53077505,2015.csv,2015,17.31384064528271,82.68615935471729
928,The Boy,64188367,35819556,28368811,2015.csv,2015,55.803812550644885,44.196187449355115
929,The Grandmaster,64076736,6594959,57481777,2013.csv,2013,10.292282990194757,89.70771700980524
930,The Pirate Fairy,63998725,0,63998725,2014.csv,2014,0.0,100.0
931,The Inbetweeners 2,63852235,0,63852235,2014.csv,2014,0.0,100.0
932,Hanna,63782078,40259119,23522959,2011.csv,2011,63.119798323284485,36.880201676715515
933,"Hail, Caesar!",63647656,30498085,33149571,2016.csv,2016,47.91705919225054,52.082940807749466
934,Footloose 2011 Re-release,63543328,51802742,11740586,2011.csv,2011,81.52349527553861,18.476504724461396
935,Conan the Barbarian,63523283,21295021,42228262,2011.csv,2011,33.523174487061695,66.47682551293829
936,Begin Again,63464861,16170632,47294229,2014.csv,2014,25.479661887229216,74.52033811277077
937,Colombiana,63458440,36665854,26792586,2011.csv,2011,57.77931824356224,42.220681756437756
938,Side Effects,63414135,32172757,31241378,2013.csv,2013,50.73436229950941,49.26563770049059
939,The Host,63365859,26627201,36738658,2013.csv,2013,42.021368320754554,57.97863167924544
940,The Hundred Regiments Offensive,63230000,0,63230000,2015.csv,2015,0.0,100.0
941,Detective Conan: Crimson Love Letter,63144805,0,63144805,2017.csv,2017,0.0,100.0
942,The Longest Ride,62944815,37446117,25498698,2015.csv,2015,59.49039170263667,40.50960829736333
943,Unfriended,62882090,32482090,30400000,2015.csv,2015,51.65555088897331,48.344449111026684
944,The Mountain Between Us,62832209,30348555,32483654,2017.csv,2017,48.30095182551993,51.69904817448007
945,The Star,62812974,40852824,21960150,2017.csv,2017,65.038830990553,34.961169009447
946,The Nice Guys,62788218,36261763,26526455,2016.csv,2016,57.752495858379035,42.247504141620965
947,Beauty and the Beast 2012 3D Release,62767829,47617067,15150762,2012.csv,2012,75.86221757008674,24.13778242991326
948,Runner Runner,62675095,19316646,43358449,2013.csv,2013,30.82028994132358,69.17971005867642
949,How to Be a Latin Lover,62547032,32149404,30397628,2017.csv,2017,51.40036700702281,48.599632992977185
950,The White Haired Witch of Lunar Kingdom,62515046,0,62515046,2014.csv,2014,0.0,100.0
951,Andhadhun,62475342,1193046,61282296,2018.csv,2018,1.9096270013215775,98.09037299867842
952,47 Meters Down,62187529,44307191,17880338,2017.csv,2017,71.24771109654478,28.752288903455224
953,Brooklyn,62076141,38322743,23753398,2015.csv,2015,61.73506017392415,38.26493982607585
954,"Dragon Ball Z: Resurrection ""F""",61768190,8008363,53759827,2015.csv,2015,12.96518968744268,87.03481031255733
955,White Snake,61631776,34730,61597046,2019.csv,2019,0.0563508018980339,99.94364919810197
956,"Everything, Everything",61621140,34121140,27500000,2017.csv,2017,55.37245821807256,44.62754178192744
957,Woman in Gold,61619773,33307793,28311980,2015.csv,2015,54.0537418078447,45.9462581921553
958,The Face Reader,61559184,515876,61043308,2013.csv,2013,0.8380163063889865,99.161983693611
959,Krampus,61548707,42725475,18823232,2015.csv,2015,69.4173396688902,30.5826603311098
960,From Up on Poppy Hill,61459425,1002895,60456530,2011.csv,2011,1.63180016734618,98.36819983265383
961,Bombshell,61404394,31762808,29641586,2019.csv,2019,51.727255870320946,48.272744129679054
962,Ashfall,61354854,372562,60982292,2019.csv,2019,0.6072249801132279,99.39277501988677
963,Astérix and Obélix: God Save Britannia,61319383,0,61319383,2012.csv,2012,0.0,100.0
964,The Legend of Hercules,61279452,18848538,42430914,2013.csv,2013,30.758333152195945,69.24166684780405
965,The Walk,61181942,10137502,51044440,2014.csv,2014,16.569434817874857,83.43056518212515
966,Doraemon: Great Adventure in the Antarctic Kachi Kochi,61153455,0,61153455,2017.csv,2017,0.0,100.0
967,Ma,61105672,45896028,15209644,2019.csv,2019,75.10927627144007,24.890723728559927
968,Snatched,60845711,45852178,14993533,2017.csv,2017,75.35811028652455,24.641889713475447
969,Kick-Ass 2,60795985,28795985,32000000,2013.csv,2013,47.36494523445915,52.63505476554084
970,What a Beautiful Day,60661950,0,60661950,2011.csv,2011,0.0,100.0
971,The Founding of an Army,60600361,0,60600361,2017.csv,2017,0.0,100.0
972,Evangelion: 3.0 You Can (Not) Redo,60488344,174945,60313399,2012.csv,2012,0.28922101091079633,99.71077898908919
973,My Little Pony: The Movie,60330833,21885107,38445726,2017.csv,2017,36.27516132588456,63.72483867411544
974,The Perfect Guy,60273173,57027435,3245738,2015.csv,2015,94.61495415215654,5.385045847843451
975,A Haunted House,60159584,40041683,20117901,2013.csv,2013,66.55910885288037,33.440891147119636
976,Beautiful Creatures,60052138,19452138,40600000,2013.csv,2013,32.3920823601651,67.60791763983491
977,My Best Summer,60011073,0,60011073,2019.csv,2019,0.0,100.0
978,Forever Young,59981902,149761,59832141,2015.csv,2015,0.24967697756566637,99.75032302243433
979,Adrift,59945012,31445012,28500000,2018.csv,2018,52.45642790095696,47.54357209904303
980,Quartet,59520298,18390117,41130181,2012.csv,2012,30.897219298196386,69.10278070180361
981,Rock of Ages,59418613,38518613,20900000,2012.csv,2012,64.82583664482374,35.17416335517626
982,Miss Granny,59396311,234573,59161738,2015.csv,2015,0.3949285671967069,99.6050714328033
983,One Day,59389433,13843771,45545662,2011.csv,2011,23.310158559688556,76.68984144031144
984,Molly's Game,59284015,28780744,30503271,2017.csv,2017,48.54722474515263,51.45277525484736
985,The Devotion of Suspect X,59035664,686435,58349229,2017.csv,2017,1.1627463019641822,98.83725369803582
986,The Gift,58978653,43787265,15191388,2015.csv,2015,74.2425653566554,25.757434643344602
987,Miss Granny,58940254,0,58940254,2014.csv,2014,0.0,100.0
988,A Walk Among the Tombstones,58834384,26307600,32526784,2014.csv,2014,44.714668891578775,55.28533110842122
989,Shock Wave,58815633,0,58815633,2017.csv,2017,0.0,100.0
990,The Tree of Life,58409247,13303319,45105928,2011.csv,2011,22.77604948408255,77.22395051591745
991,Beginning of the Great Revival,58309289,151000,58158289,2011.csv,2011,0.2589638848108746,99.74103611518913
992,Huo guo ying xiong,58106427,779818,57326609,2016.csv,2016,1.3420511985705126,98.65794880142948
993,L.O.R.D: Legend of Ravaging Dynasties,58089494,350456,57739038,2016.csv,2016,0.603303585326462,99.39669641467354
994,Snitch,57824674,42930462,14894212,2013.csv,2013,74.2424626553018,25.757537344698218
995,Dolphin Tale 2,57824533,42024533,15800000,2014.csv,2014,72.67595745217692,27.324042547823087
996,Nine Lives,57814445,19700032,38114413,2016.csv,2016,34.07458464748732,65.92541535251269
997,That's My Boy,57719093,36931089,20788004,2012.csv,2012,63.984181109706626,36.015818890293374
998,Goldbuster,57628292,186135,57442157,2017.csv,2017,0.3229923940831007,99.6770076059169
999,Ready or Not,57615777,28714231,28901546,2019.csv,2019,49.83744469852416,50.16255530147584
1000,The Physician,57284237,0,57284237,2013.csv,2013,0.0,100.0
1001,Jade Dynasty,57149764,0,57149764,2019.csv,2019,0.0,100.0
1002,Killer Elite,57084522,25124966,31959556,2011.csv,2011,44.013622466699466,55.986377533300534
1003,Gekijouban Tenpesuto 3D,57082491,0,57082491,2011.csv,2011,0.0,100.0
1004,The 15:17 to Paris,57076286,36276286,20800000,2018.csv,2018,63.55754472181319,36.44245527818681
1005,All the Money in the World,56996304,25113707,31882597,2017.csv,2017,44.061992160053045,55.938007839946955
1006,Zoolander 2,56722693,28848693,27874000,2016.csv,2016,50.85917377018754,49.14082622981247
1007,You Are My Sunshine,56640000,0,56640000,2015.csv,2015,0.0,100.0
1008,Das perfekte Geheimnis,56573047,0,56573047,2019.csv,2019,0.0,100.0
1009,The Big Sick,56411585,42873127,13538458,2017.csv,2017,76.00057151381228,23.99942848618772
1010,A or B,56239049,0,56239049,2018.csv,2018,0.0,100.0
1011,The Big Shot,56040681,0,56040681,2019.csv,2019,0.0,100.0
1012,The Odd Life of Timothy Green,56012642,51854875,4157767,2012.csv,2012,92.57709179295631,7.4229082070436885
1013,Gongjo,55972241,475618,55496623,2017.csv,2017,0.8497390697649573,99.15026093023505
1014,Firestorm,55754766,0,55754766,2013.csv,2013,0.0,100.0
1015,Dallas Buyers Club,55736588,27298285,28438303,2013.csv,2013,48.977316300739474,51.022683699260526
1016,All Eyez on Me,55668698,44922302,10746396,2017.csv,2017,80.6958014358446,19.30419856415539
1017,Lawless,55404159,37400127,18004032,2012.csv,2012,67.50418682467502,32.495813175324976
1018,Silent Hill: Revelation,55362705,17529157,37833548,2011.csv,2011,31.662392579986836,68.33760742001317
1019,Extremely Loud & Incredibly Close,55247881,31847881,23400000,2011.csv,2011,57.64543440136646,42.35456559863355
1020,End of Watch,55078146,41003371,14074775,2012.csv,2012,74.4458083247755,25.55419167522451
1021,Hellboy,55064690,21903748,33160942,2019.csv,2019,39.77820995632592,60.22179004367408
1022,Wolf Children,55045228,0,55045228,2012.csv,2012,0.0,100.0
1023,Barbershop: The Next Cut,55030051,54030051,1000000,2016.csv,2016,98.18281106081476,1.8171889391852463
1024,Downsizing,55003890,24449754,30554136,2017.csv,2017,44.45095428705134,55.54904571294866
1025,St. Vincent,54837234,44137712,10699522,2014.csv,2014,80.48858190039272,19.511418099607287
1026,The Three Stooges,54819301,44338224,10481077,2012.csv,2012,80.88068105793614,19.119318942063853
1027,Go Brother!,54663060,0,54663060,2018.csv,2018,0.0,100.0
1028,Early Man,54622814,8267544,46355270,2018.csv,2018,15.135697695838227,84.86430230416178
1029,The Age of Shadows,54491162,541719,53949443,2016.csv,2016,0.9941410315309481,99.00585896846906
1030,No Escape,54418872,27288872,27130000,2015.csv,2015,50.14597141962075,49.85402858037925
1031,No Good Deed,54323210,52543632,1779578,2014.csv,2014,96.72409270365281,3.275907296347178
1032,The Five-Year Engagement,54169363,28835528,25333835,2012.csv,2012,53.23217110749484,46.76782889250516
1033,Madea's Big Happy Family,54161287,53345287,816000,2011.csv,2011,98.49338882955274,1.5066111704472605
1034,A Ghost of a Chance,53982636,0,53982636,2011.csv,2011,0.0,100.0
1035,"I, Tonya",53939297,30014539,23924758,2017.csv,2017,55.64503185868366,44.35496814131634
1036,Peppermint,53918723,35418723,18500000,2018.csv,2018,65.68909838610236,34.31090161389764
1037,Long Shot,53873809,30316271,23557538,2019.csv,2019,56.27274470234692,43.72725529765308
1038,1987: When the Day Comes,53834292,0,53834292,2017.csv,2017,0.0,100.0
1039,Overheard 3,53493428,0,53493428,2014.csv,2014,0.0,100.0
1040,Supercondriaque,53425036,0,53425036,2014.csv,2014,0.0,100.0
1041,A Madea Christmas,53396635,52543354,853281,2013.csv,2013,98.40199480735069,1.598005192649312
1042,Sinister 2,53329150,27740955,25588195,2015.csv,2015,52.01837081596088,47.98162918403912
1043,A Chinese Odyssey: Part Three,53306108,0,53306108,2016.csv,2016,0.0,100.0
1044,3 Days to Kill,53260230,30697999,22562231,2014.csv,2014,57.63775147046868,42.36224852953132
1045,Temptation: Confessions of a Marriage Counselor,53143144,51975354,1167790,2013.csv,2013,97.80255756038822,2.1974424396117778
1046,Delivery Man,53120346,30664106,22456240,2013.csv,2013,57.72572716299702,42.27427283700298
1047,The Outlaws,52946454,0,52946454,2017.csv,2017,0.0,100.0
1048,Detective Conan: Sunflowers of Inferno,52920296,0,52920296,2015.csv,2015,0.0,100.0
1049,Prem Ratan Dhan Payo,52715771,4364639,48351132,2015.csv,2015,8.279569694617575,91.72043030538242
1050,Rurouni Kenshin Part II: Kyoto Inferno,52696176,0,52696176,2014.csv,2014,0.0,100.0
1051,Wild,52501541,37880356,14621185,2014.csv,2014,72.15094124570554,27.84905875429447
1052,Tunnel,52444295,568876,51875419,2016.csv,2016,1.0847242774452397,98.91527572255477
1053,The Boy Next Door,52425855,35423380,17002475,2015.csv,2015,67.5685308327351,32.43146916726489
1054,The Night Before,52395996,43047372,9348624,2015.csv,2015,82.15775113808314,17.842248861916854
1055,Hollywood Adventures,52265070,0,52265070,2015.csv,2015,0.0,100.0
1056,Patriots Day,52185751,31886361,20299390,2016.csv,2016,61.10166163940038,38.898338360599624
1057,My Beloved Bodyguard,52165873,0,52165873,2016.csv,2016,0.0,100.0
1058,The Finest Hours,52099090,27569558,24529532,2016.csv,2016,52.917542321756486,47.082457678243514
1059,Teen Titans GO! To the Movies,52090236,29790236,22300000,2018.csv,2018,57.18967370391641,42.81032629608359
1060,"Yo-kai Watch Movie: It's the Secret of Birth, Meow!",51838845,257343,51581502,2015.csv,2015,0.4964288845555876,99.50357111544442
1061,Slender Man,51738549,30569484,21169065,2018.csv,2018,59.08454061979975,40.91545938020025
1062,Master,51636415,597251,51039164,2016.csv,2016,1.1566469128424195,98.84335308715758
1063,Breaking In,51411620,46840590,4571030,2018.csv,2018,91.10895552406247,8.89104447593754
1064,Cry Me a Sad River,51400614,0,51400614,2018.csv,2018,0.0,100.0
1065,Hot Pursuit,51380201,34580201,16800000,2015.csv,2015,67.30258022929883,32.69741977070117
1066,Once Upon a Deadpool 2018 Re-release,51349833,6100309,45249524,2018.csv,2018,11.87990036890675,88.12009963109325
1067,Simmba,51329025,5102129,46226896,2018.csv,2018,9.9400465915727,90.05995340842729
1068,The 100 Year-Old Man Who Climbed Out the Window and Disappeared,51167572,944193,50223379,2013.csv,2013,1.8452956884489262,98.15470431155107
1069,Sunny,51116421,0,51116421,2011.csv,2011,0.0,100.0
1070,Magic in the Moonlight,51029361,10539326,40490035,2014.csv,2014,20.653454782629947,79.34654521737005
1071,Red Dawn,50950296,44806783,6143513,2012.csv,2012,87.94214463444922,12.05785536555077
1072,Doraemon the Movie: Nobita and the Birth of Japan,50939840,0,50939840,2016.csv,2016,0.0,100.0
1073,War of the Arrows,50587661,251200,50336461,2011.csv,2011,0.49656377668854856,99.50343622331145
1074,Kingdom,50574061,0,50574061,2019.csv,2019,0.0,100.0
1075,The Himalayas,50544493,696717,49847776,2015.csv,2015,1.3784231647154914,98.62157683528451
1076,Dragon Ball Z: Battle of Gods,50461371,2553002,47908369,2013.csv,2013,5.059319533747904,94.94068046625209
1077,Kokowääh,50447784,0,50447784,2011.csv,2011,0.0,100.0
1078,About Last Night,50445860,48637684,1808176,2014.csv,2014,96.41561071612219,3.584389283877805
1079,Breakthrough,50444358,40713082,9731276,2019.csv,2019,80.70889117074303,19.29110882925698
1080,Just Mercy,50401502,36001502,14400000,2019.csv,2019,71.4294228771198,28.570577122880188
1081,Red Tails,50365498,49876377,489121,2012.csv,2012,99.02885701636465,0.9711429836353449
1082,"Monsters, Inc. 2012 3D Release",50207820,34043006,16164814,2012.csv,2012,67.80419066193274,32.19580933806726
1083,HOUBA! On the Trail of the Marsupilami,50146474,0,50146474,2012.csv,2012,0.0,100.0
1084,Uncut Gems,50023780,50023780,0,2019.csv,2019,100.0,0.0
1085,Dearest 2014 Re-release,50000583,0,50000583,2014.csv,2014,0.0,100.0
1086,Family is Family,49954866,0,49954866,2018.csv,2018,0.0,100.0
1087,21 Bridges,49939757,28539757,21400000,2019.csv,2019,57.14836978481894,42.85163021518106
1088,Winnie the Pooh,49871429,26692846,23178583,2011.csv,2011,53.5233229430823,46.4766770569177
1089,The Wailing,49851770,786633,49065137,2016.csv,2016,1.5779439727014708,98.42205602729854
1090,The Boy and the Beast,49714378,490643,49223735,2015.csv,2015,0.9869237426645466,99.01307625733546
1091,Two Is a Family,49619118,0,49619118,2016.csv,2016,0.0,100.0
1092,Song of Youth,49615508,0,49615508,2019.csv,2019,0.0,100.0
1093,Surprise,49567466,0,49567466,2015.csv,2015,0.0,100.0
1094,Death Wish,49562710,34017028,15545682,2018.csv,2018,68.63431801852643,31.36568198147357
1095,The Grudge,49511319,21221803,28289516,2019.csv,2019,42.86252806151256,57.13747193848744
1096,Tad: The Lost Explorer,49490859,0,49490859,2012.csv,2012,0.0,100.0
1097,Entourage,49263404,32363404,16900000,2015.csv,2015,65.69461582476112,34.305384175238885
1098,A Turtle's Tale 2: Sammy's Escape from Paradise,49261830,0,49261830,2012.csv,2012,0.0,100.0
1099,Little,48987096,40860481,8126615,2019.csv,2019,83.41070268790786,16.589297312092146
1100,Whiplash,48982041,13092000,35890041,2014.csv,2014,26.72816349159481,73.2718365084052
1101,Never Gone,48980792,96421,48884371,2016.csv,2016,0.19685471806989158,99.8031452819301
1102,The Berlin File,48972848,665210,48307638,2013.csv,2013,1.3583241064518037,98.6416758935482
1103,Trouble with the Curve,48963137,35763137,13200000,2012.csv,2012,73.04094302617906,26.95905697382094
1104,Luck-Key,48913975,466505,48447470,2016.csv,2016,0.9537253923853051,99.04627460761469
1105,Florence Foster Jenkins,48902953,27383770,21519183,2016.csv,2016,55.996148126269595,44.003851873730405
1106,The Woman in Black 2: Angel of Death,48854305,26501323,22352982,2015.csv,2015,54.24562482262311,45.7543751773769
1107,Bleeding Steel,48825526,0,48825526,2017.csv,2017,0.0,100.0
1108,Isn't It Romantic,48791187,48791187,0,2019.csv,2019,100.0,0.0
1109,Mother's Day,48782670,32492859,16289811,2016.csv,2016,66.60738126879893,33.392618731201054
1110,Concussion,48623572,34542474,14081098,2015.csv,2015,71.04059323325733,28.959406766742685
1111,Her,48517427,25568251,22949176,2013.csv,2013,52.69910747740189,47.30089252259811
1112,The Legend of Hei,48507082,0,48507082,2019.csv,2019,0.0,100.0
1113,Logan Lucky,48453605,27780977,20672628,2017.csv,2017,57.33521169374291,42.66478830625709
1114,Homefront,48449416,20158898,28290518,2013.csv,2013,41.608134141389854,58.391865858610146
1115,Chef,48428048,31424003,17004045,2014.csv,2014,64.88802315550691,35.11197684449309
1116,Boo 2! A Madea Halloween,48333932,47319572,1014360,2017.csv,2017,97.9013501322425,2.0986498677575
1117,The Last Stand,48330757,12050299,36280458,2013.csv,2013,24.932982117370933,75.06701788262907
1118,Arthur,48147945,33035397,15112548,2011.csv,2011,68.61226787560715,31.387732124392848
1119,Boyhood,48137666,25352281,22785385,2014.csv,2014,52.66620321807874,47.33379678192125
1120,21 & Over,48065672,25682380,22383292,2013.csv,2013,53.431854650861844,46.56814534913815
1121,Sky Hunter,48065601,0,48065601,2017.csv,2017,0.0,100.0
1122,Countdown,48021766,25621766,22400000,2019.csv,2019,53.35448513076341,46.645514869236585
1123,Midsommar,47863365,27426361,20437004,2019.csv,2019,57.301363997286856,42.698636002713144
1124,Queen & Slim,47860909,43808310,4052599,2019.csv,2019,91.53254903704399,8.467450962956011
1125,Phantom Thread,47756590,21198205,26558385,2017.csv,2017,44.38802058522185,55.61197941477815
1126,"Yo-kai Watch Movie: It's the Secret of Birth, Meow! 2016 Re-release",47642462,0,47642462,2016.csv,2016,0.0,100.0
1127,Man on a Ledge,47636031,18620000,29016031,2012.csv,2012,39.08805920459662,60.911940795403375
1128,Inside Men,47616503,0,47616503,2015.csv,2015,0.0,100.0
1129,The Dead End,47600000,0,47600000,2015.csv,2015,0.0,100.0
1130,Coming Home,47587984,377607,47210377,2014.csv,2014,0.7934923236084135,99.20650767639158
1131,47 Meters Down: Uncaged,47582563,22260900,25321663,2019.csv,2019,46.783734621441056,53.216265378558944
1132,Boonie Bears Winter,47581416,0,47581416,2015.csv,2015,0.0,100.0
1133,Beauty and the Beast,47430624,0,47430624,2014.csv,2014,0.0,100.0
1134,The Magic Tuche,47427990,0,47427990,2018.csv,2018,0.0,100.0
1135,Nightcrawler,47398992,32381217,15017775,2014.csv,2014,68.3162565988745,31.68374340112549
1136,Rough Night,47347283,22105643,25241640,2017.csv,2017,46.6883031070653,53.3116968929347
1137,Texas Chainsaw,47340586,34341945,12998641,2013.csv,2013,72.54228961170865,27.45771038829135
1138,A Monster Calls,47309313,3740823,43568490,2016.csv,2016,7.907159843982516,92.09284015601749
1139,Tiny Times 2.0,47289937,43788,47246149,2013.csv,2013,0.09259475224084143,99.90740524775916
1140,Golden Job,47287851,285795,47002056,2018.csv,2018,0.6043729921243407,99.39562700787566
1141,Mortdecai,47275695,7696134,39579561,2015.csv,2015,16.279261468287245,83.72073853171275
1142,Switch,47164301,0,47164301,2013.csv,2013,0.0,100.0
1143,Soul Surfer,47120948,43853424,3267524,2011.csv,2011,93.06566582658736,6.9343341734126405
1144,The Place Beyond the Pines,47052899,21403519,25649380,2013.csv,2013,45.48820466938711,54.51179533061289
1145,Son of Bigfoot,47046281,289308,46756973,2017.csv,2017,0.6149434000957483,99.38505659990426
1146,Parker,46922566,17616641,29305925,2013.csv,2013,37.54406994706982,62.455930052930185
1147,Mary Queen of Scots,46712809,16468499,30244310,2018.csv,2018,35.25478204489907,64.74521795510093
1148,Uncle Drew,46664414,42469946,4194468,2018.csv,2018,91.01142039413588,8.988579605864118
1149,Three Seconds,46596415,0,46596415,2017.csv,2017,0.0,100.0
1150,The Big Wedding,46522137,21819348,24702789,2013.csv,2013,46.90100112984922,53.09899887015078
1151,Badges of Fury,46495296,0,46495296,2013.csv,2013,0.0,100.0
1152,Risen,46432579,36880033,9552546,2016.csv,2016,79.42706133122608,20.572938668773926
1153,Acrimony,46403669,43549096,2854573,2018.csv,2018,93.84838944523977,6.151610554760229
1154,A Werewolf Boy,46282588,342922,45939666,2012.csv,2012,0.7409309090494248,99.25906909095058
1155,The Thousand Faces of Dunjia,46263237,124187,46139050,2017.csv,2017,0.2684356047113608,99.73156439528864
1156,The Battleship Island,46183383,1104957,45078426,2017.csv,2017,2.392542356630739,97.60745764336927
1157,Doraemon: Nobita and the Island of Miracles ~Animal Adventure~,46180706,0,46180706,2012.csv,2012,0.0,100.0
1158,Hanson and the Beast,46154323,0,46154323,2017.csv,2017,0.0,100.0
1159,Eddie the Eagle,46152800,15789389,30363411,2016.csv,2016,34.2111182853478,65.7888817146522
1160,The World's End,46089287,26004851,20084436,2013.csv,2013,56.42276696534707,43.577233034652934
1161,Gekijouban Tenpesuto 3D 2012 Re-release,46008255,0,46008255,2012.csv,2012,0.0,100.0
1162,Let's Get Married,45972724,462918,45509806,2015.csv,2015,1.0069405502271302,98.99305944977287
1163,Asterix: The Secret of the Magic Potion,45972321,1271953,44700368,2018.csv,2018,2.7667800370575155,97.23321996294248
1164,Gintama Live Action the Movie,45746967,0,45746967,2017.csv,2017,0.0,100.0
1165,Somewhere Only We Know,45737711,482341,45255370,2015.csv,2015,1.0545805407708313,98.94541945922917
1166,Chasing the Dragon II: Wild Wild Bunch,45733356,196634,45536722,2019.csv,2019,0.42995751284904615,99.57004248715096
1167,"McFarland, USA",45710059,44482410,1227649,2015.csv,2015,97.31426949153577,2.685730508464231
1168,Judy,45701880,24313888,21387992,2019.csv,2019,53.20106743967644,46.79893256032356
1169,Guilty of Mind,45698503,0,45698503,2017.csv,2017,0.0,100.0
1170,Earth to Echo,45681062,38934842,6746220,2014.csv,2014,85.23191076424624,14.768089235753756
1171,That Awkward Moment,45640143,26068955,19571188,2014.csv,2014,57.11847791537375,42.88152208462625
1172,The Debt,45636368,31177548,14458820,2011.csv,2011,68.31732972264575,31.682670277354237
1173,Bajrangi Bhaijaan 2018 Re-release,45579004,0,45579004,2018.csv,2018,0.0,100.0
1174,Hero,45565534,88675,45476859,2015.csv,2015,0.19460981188105905,99.80539018811893
1175,Love on the Cloud,45386560,271734,45114826,2014.csv,2014,0.5987102789900799,99.40128972100992
1176,Blair Witch,45173154,20777061,24396093,2016.csv,2016,45.99426686035693,54.00573313964308
1177,Flatliners,45158254,16883115,28275139,2017.csv,2017,37.38655396198445,62.61344603801555
1178,Boonie Bears: The Big Top Secret,45150390,0,45150390,2016.csv,2016,0.0,100.0
1179,Grudge Match,44907260,29807260,15100000,2013.csv,2013,66.37514735924658,33.62485264075341
1180,Child's Play,44907074,29208403,15698671,2019.csv,2019,65.04187513976083,34.95812486023917
1181,Still Alice,44779195,18754371,26024824,2015.csv,2015,41.88188510311541,58.118114896884585
1182,The White Storm,44670277,0,44670277,2013.csv,2013,0.0,100.0
1183,Bad Genius,44560421,0,44560421,2017.csv,2017,0.0,100.0
1184,Mother!,44516999,17800004,26716995,2017.csv,2017,39.984734820062776,60.01526517993722
1185,Oculus,44446287,27695246,16751041,2014.csv,2014,62.31172021185931,37.68827978814068
1186,Detective Conan: The Eleventh Striker,44369456,0,44369456,2012.csv,2012,0.0,100.0
1187,House at the End of the Street,44287131,31611916,12675215,2012.csv,2012,71.37946235442526,28.62053764557474
1188,Tarzan,44095996,0,44095996,2013.csv,2013,0.0,100.0
1189,The Great Hypnotist,44077818,0,44077818,2014.csv,2014,0.0,100.0
1190,Winchester,44019588,25091816,18927772,2018.csv,2018,57.00147852360635,42.99852147639365
1191,Kick,43996483,2472695,41523788,2014.csv,2014,5.6202105972879695,94.37978940271203
1192,Wind River,43980821,33800859,10179962,2017.csv,2017,76.85363354176586,23.146366458234148
1193,Max,43967255,42656255,1311000,2015.csv,2015,97.01823550276222,2.9817644972377737
1194,Battle of Memories,43892362,594552,43297810,2017.csv,2017,1.354568250393998,98.645431749606
1195,Son of a Rich,43833888,0,43833888,2019.csv,2019,0.0,100.0
1196,Café Society,43763247,11103205,32660042,2016.csv,2016,25.371072215002695,74.6289277849973
1197,Richard Jewell,43745542,22345542,21400000,2019.csv,2019,51.080729551824966,48.91927044817504
1198,The DUFF,43709744,34030343,9679401,2015.csv,2015,77.85527867653491,22.144721323465085
1199,League of Gods,43498766,181633,43317133,2016.csv,2016,0.4175589716728976,99.58244102832711
1200,Secretly Greatly,43447199,0,43447199,2013.csv,2013,0.0,100.0
1201,Harriet,43347017,43082155,264862,2019.csv,2019,99.38897294824231,0.6110270517576792
1202,Beastly,43202283,27865571,15336712,2011.csv,2011,64.50022791619601,35.499772083804
1203,The Snowman,43155261,6700035,36455226,2017.csv,2017,15.52541878961177,84.47458121038824
1204,A Shaun the Sheep Movie: Farmageddon,43100248,0,43100248,2019.csv,2019,0.0,100.0
1205,Annihilation,43070915,32732301,10338614,2018.csv,2018,75.99629819798349,24.00370180201651
1206,Gifted,43046590,24801212,18245378,2017.csv,2017,57.614812230190594,42.385187769809406
1207,The Possession of Hannah Grace,43016528,14837422,28179106,2018.csv,2018,34.492374651901244,65.50762534809877
1208,Legend,42972994,1872994,41100000,2015.csv,2015,4.358537364187378,95.64146263581263
1209,"The Chef, The Actor, The Scoundrel",42970000,0,42970000,2013.csv,2013,0.0,100.0
1210,The Gallows,42964410,22764410,20200000,2015.csv,2015,52.98434215668271,47.01565784331729
1211,Asterix and Obelix: Mansion of the Gods,42830578,0,42830578,2014.csv,2014,0.0,100.0
1212,Detective Conan: Quarter of Silence,42808575,0,42808575,2011.csv,2011,0.0,100.0
1213,Doraemon: Nobita's Secret Gadget Museum,42770271,0,42770271,2013.csv,2013,0.0,100.0
1214,Shaolin,42741494,66099,42675395,2011.csv,2011,0.1546483143523247,99.84535168564767
1215,Almost Christmas,42580920,42158780,422140,2016.csv,2016,99.00861700498722,0.9913829950127897
1216,Thermae Romae II,42473163,0,42473163,2014.csv,2014,0.0,100.0
1217,Love the Coopers,42426912,26302731,16124181,2015.csv,2015,61.99539339558816,38.00460660441184
1218,Loving Vincent,42187665,6735118,35452547,2017.csv,2017,15.964661708582353,84.03533829141764
1219,The Throne,42165755,0,42165755,2015.csv,2015,0.0,100.0
1220,Long Day's Journey Into Night,42140994,521365,41619629,2018.csv,2018,1.237191984602926,98.76280801539707
1221,Jobs,42128352,16131410,25996942,2013.csv,2013,38.29110144161348,61.70889855838653
1222,Bang Bang,42045981,2546172,39499809,2014.csv,2014,6.055684608714445,93.94431539128556
1223,Detective Conan: The Sniper from Another Dimension,42028116,0,42028116,2014.csv,2014,0.0,100.0
1224,Mary and the Witch's Flower,41978431,2418404,39560027,2017.csv,2017,5.7610633422673665,94.23893665773264
1225,Rurouni Kenshin: The Legend Ends,41900000,0,41900000,2014.csv,2014,0.0,100.0
1226,"As Above, So Below",41898409,21321100,20577309,2014.csv,2014,50.887612462802586,49.112387537197414
1227,Call Me by Your Name,41887595,18095701,23791894,2017.csv,2017,43.20062061333433,56.79937938666567
1228,The Guilt Trip,41863726,37134215,4729511,2012.csv,2012,88.70260377683535,11.297396223164656
1229,No Man's Land,41807712,0,41807712,2013.csv,2013,0.0,100.0
1230,T2 Trainspotting,41681746,2402004,39279742,2017.csv,2017,5.762724047116452,94.23727595288355
1231,Overlord,41657844,21704844,19953000,2018.csv,2018,52.10265802522089,47.89734197477911
1232,Born to Be Wild,41644475,25978556,15665919,2011.csv,2011,62.38175892480336,37.61824107519665
1233,Safe,41564670,17142080,24422590,2012.csv,2012,41.24194899177595,58.75805100822406
1234,The Great Battle,41509280,472166,41037114,2018.csv,2018,1.13749503725432,98.86250496274567
1235,Lupin III vs. Detective Conan: The Movie,41397727,0,41397727,2013.csv,2013,0.0,100.0
1236,The Lady in the Van,41387687,10021175,31366512,2015.csv,2015,24.212938017048405,75.7870619829516
1237,Shark Night,41363927,18877153,22486774,2011.csv,2011,45.636752525938846,54.36324747406115
1238,Ricki and the Flash,41325328,26822144,14503184,2015.csv,2015,64.9048544756862,35.0951455243138
1239,This Is Where I Leave You,41296320,34296320,7000000,2014.csv,2014,83.04933708378857,16.95066291621142
1240,The Darkest Minds,41142379,12695691,28446688,2018.csv,2018,30.857940908084096,69.14205909191591
1241,50/50,41097853,35014192,6083661,2011.csv,2011,85.19713183070658,14.802868169293419
1242,Fist Fight,41087017,32187017,8900000,2017.csv,2017,78.33865622320549,21.661343776794503
1243,"Lost, Found",41043552,0,41043552,2018.csv,2018,0.0,100.0
1244,Dredd,41037742,13414714,27623028,2012.csv,2012,32.6887234682649,67.3112765317351
1245,Fright Night,41002607,18302607,22700000,2011.csv,2011,44.63766657568871,55.36233342431128
1246,La vérité si je mens! 3,40928635,0,40928635,2012.csv,2012,0.0,100.0
1247,Always: Sunset on Third Street '64,40923305,0,40923305,2012.csv,2012,0.0,100.0
1248,Drive Angry,40909909,10721033,30188876,2011.csv,2011,26.2064454848824,73.79355451511759
1249,Fighting with My Family,40812363,22958886,17853477,2019.csv,2019,56.25473340026893,43.74526659973107
1250,30 Minutes or Less,40662632,37053924,3608708,2011.csv,2011,91.12524737700205,8.87475262299794
1251,The Circle,40656399,20497844,20158555,2017.csv,2017,50.4172639588666,49.5827360411334
1252,Ocho apellidos catalanes,40591862,0,40591862,2015.csv,2015,0.0,100.0
1253,Gantz,40568961,0,40568961,2011.csv,2011,0.0,100.0
1254,The Roommate,40492652,37300000,3192652,2011.csv,2011,92.11547813662587,7.8845218633741245
1255,Holmes & Watson,40466970,30573626,9893344,2018.csv,2018,75.55205146320567,24.44794853679433
1256,The Witch,40423945,25138705,15285240,2016.csv,2016,62.18765882449128,37.81234117550872
1257,Masquerade Hotel,40396244,0,40396244,2019.csv,2019,0.0,100.0
1258,Carol,40272135,12711491,27560644,2015.csv,2015,31.56398586764769,68.43601413235231
1259,Yolki 3,40267368,0,40267368,2013.csv,2013,0.0,100.0
1260,SP: The Motion Picture II,40255101,0,40255101,2011.csv,2011,0.0,100.0
1261,Boonie Bears: To the Rescue,40163675,0,40163675,2014.csv,2014,0.0,100.0
1262,Diary of a Wimpy Kid: The Long Haul,40140972,20738724,19402248,2017.csv,2017,51.66472799911273,48.33527200088727
1263,The Wild Life,40075446,8005586,32069860,2016.csv,2016,19.976286726790267,80.02371327320974
1264,Northern Limit Line,40034677,337907,39696770,2015.csv,2015,0.8440357842777151,99.15596421572228
1265,Dream House,39984400,21302340,18682060,2011.csv,2011,53.276627884875104,46.7233721151249
1266,Love O2O,39969537,0,39969537,2016.csv,2016,0.0,100.0
1267,Brotherhood of Blades 2,39966092,14204,39951888,2017.csv,2017,0.035540127365968135,99.96445987263404
1268,Monte Carlo,39782683,23186769,16595914,2011.csv,2011,58.28357277964385,41.71642722035615
1269,Eiga Kaibutsukun,39766344,0,39766344,2011.csv,2011,0.0,100.0
1270,The Last Wish,39756292,0,39756292,2019.csv,2019,0.0,100.0
1271,Midnight Runners,39730433,0,39730433,2017.csv,2017,0.0,100.0
1272,The Forest,39712000,26594261,13117739,2016.csv,2016,66.96782080983078,33.03217919016922
1273,The November Man,39661919,25018119,14643800,2014.csv,2014,63.078438035234754,36.921561964765246
1274,Intimate Strangers,39576060,0,39576060,2018.csv,2018,0.0,100.0
1275,Thugs of Hindostan,39570044,1449848,38120196,2018.csv,2018,3.6640040127324602,96.33599598726754
1276,Recep Ivedik 4,39477906,0,39477906,2014.csv,2014,0.0,100.0
1277,Don Jon,39439355,24477704,14961651,2013.csv,2013,62.06415901071405,37.93584098928596
1278,Sin City: A Dame to Kill For,39407616,13757804,25649812,2014.csv,2014,34.91153588179503,65.08846411820497
1279,Uri: The Surgical Strike,39346577,4186168,35160409,2019.csv,2019,10.639217739322024,89.36078226067798
1280,The Gambler,39280992,33680992,5600000,2014.csv,2014,85.74374089126874,14.256259108731268
1281,Mars Needs Moms,39233678,21392758,17840920,2011.csv,2011,54.526516733914164,45.473483266085836
1282,Absolutely Fabulous: The Movie,39219109,4772155,34446954,2016.csv,2016,12.167933238870878,87.83206676112913
1283,My Mom Is a Character 2,39195565,0,39195565,2016.csv,2016,0.0,100.0
1284,Sink or Swim,39193850,0,39193850,2018.csv,2018,0.0,100.0
1285,Samba,39178695,151530,39027165,2014.csv,2014,0.3867663279749364,99.61323367202506
1286,Show Dogs,39156854,17857020,21299834,2018.csv,2018,45.603816894993656,54.396183105006344
1287,Women Who Flirt,39156132,375495,38780637,2014.csv,2014,0.9589685722787942,99.04103142772121
1288,Masterpiece Mystery: Sherlock: The Abominable Bride,39139204,0,39139204,2016.csv,2016,0.0,100.0
1289,Ex-Files 2: The Backup Strikes Back,39108291,0,39108291,2015.csv,2015,0.0,100.0
1290,Believer,39047153,365639,38681514,2018.csv,2018,0.9364037372968012,99.0635962627032
1291,The Crown Jewels,39000000,0,39000000,2011.csv,2011,0.0,100.0
1292,Forbidden Empire 2014 Re-release,38885962,0,38885962,2014.csv,2014,0.0,100.0
1293,The Spy Gone North,38844509,500803,38343706,2018.csv,2018,1.2892504317663018,98.71074956823371
1294,Criminal,38803993,14708696,24095297,2015.csv,2015,37.90510940459143,62.09489059540857
1295,Antoine and Sebastian,38719881,0,38719881,2013.csv,2013,0.0,100.0
1296,On the Basis of Sex,38673750,24622687,14051063,2018.csv,2018,63.66769966708685,36.33230033291316
1297,"Crouching Tiger, Hidden Dragon: Sword of Destiny",38659039,0,38659039,2016.csv,2016,0.0,100.0
1298,The Best of Me,38609668,26766213,11843455,2014.csv,2014,69.32515710831805,30.674842891681948
1299,Taxi 5,38598227,0,38598227,2018.csv,2018,0.0,100.0
1300,Million Dollar Arm,38483455,36457627,2025828,2014.csv,2014,94.73584687237671,5.2641531276232865
1301,Chernobyl Diaries,38390020,18119640,20270380,2012.csv,2012,47.19882927906784,52.801170720932156
1302,Boruto: Naruto The Movie,38362448,919651,37442797,2015.csv,2015,2.3972688082887723,97.60273119171123
1303,The Lazarus Effect,38356892,25801570,12555322,2015.csv,2015,67.26710287162996,32.73289712837005
1304,Don't Be Afraid of the Dark,38269529,24046682,14222847,2011.csv,2011,62.835061283351564,37.164938716648436
1305,The Water Diviner,38176317,4196641,33979676,2014.csv,2014,10.992786444014492,89.00721355598552
1306,Jumping the Broom,38158601,37295394,863207,2011.csv,2011,97.73784421499101,2.262155785008994
1307,One for the Money,38080789,26414527,11666262,2011.csv,2011,69.36444252770077,30.635557472299226
1308,But Always,38039248,430760,37608488,2014.csv,2014,1.1324093473141215,98.86759065268588
1309,Overcomer,38026103,34746945,3279158,2019.csv,2019,91.37656046426845,8.623439535731547
1310,The Eagle,37989684,19490041,18499643,2011.csv,2011,51.30350913158425,48.69649086841575
1311,Helios,37938005,0,37938005,2015.csv,2015,0.0,100.0
1312,Killing Them Softly,37930465,15026056,22904409,2012.csv,2012,39.61474239770064,60.38525760229937
1313,The King,37886707,0,37886707,2017.csv,2017,0.0,100.0
1314,Hell or High Water,37879877,27007844,10872033,2016.csv,2016,71.29865812394269,28.701341876057306
1315,Cold Eyes,37795598,0,37795598,2013.csv,2013,0.0,100.0
1316,Mission Milano,37749848,0,37749848,2016.csv,2016,0.0,100.0
1317,The Handmaiden,37692886,2006788,35686098,2016.csv,2016,5.3240497424368085,94.67595025756319
1318,Rurouni Kenshin Part I: Origins,37654579,0,37654579,2012.csv,2012,0.0,100.0
1319,Pokémon the Movie: I Choose You!,37552144,2401722,35150422,2017.csv,2017,6.395698738266449,93.60430126173355
1320,Fat Buddies,37496410,0,37496410,2018.csv,2018,0.0,100.0
1321,A Walk in the Woods,37461274,29504281,7956993,2015.csv,2015,78.75941699153104,21.240583008468956
1322,Pain and Glory,37359689,4567338,32792351,2019.csv,2019,12.225310547954509,87.7746894520455
1323,Snowden,37357216,21587519,15769697,2016.csv,2016,57.786744601096615,42.213255398903385
1324,Home Again,37270721,27020284,10250437,2017.csv,2017,72.49734718037786,27.502652819622135
1325,"Like Father, Like Son",37170163,334616,36835547,2013.csv,2013,0.9002274216553745,99.09977257834463
1326,A Witness Out of the Blue,37092694,0,37092694,2019.csv,2019,0.0,100.0
1327,Till The End Of The World,37013733,118660,36895073,2018.csv,2018,0.3205837141582018,99.6794162858418
1328,2.0,36945969,4152000,32793969,2018.csv,2018,11.238032490093845,88.76196750990616
1329,Devil's Due,36921560,15821461,21100099,2014.csv,2014,42.8515506928743,57.1484493071257
1330,Ex Machina,36869414,25442958,11426456,2015.csv,2015,69.00830590906598,30.99169409093402
1331,The Adventurers,36796816,216556,36580260,2017.csv,2017,0.5885183109321197,99.41148168906788
1332,Burnt,36606743,13651946,22954797,2015.csv,2015,37.29352813496683,62.70647186503317
1333,The Intruder,36599361,35419122,1180239,2019.csv,2019,96.77524697767265,3.224753022327357
1334,The Priests,36577134,185093,36392041,2015.csv,2015,0.5060347265042691,99.49396527349573
1335,The Tower,36512327,0,36512327,2012.csv,2012,0.0,100.0
1336,Detective Conan: Private Eye in the Distant Sea,36324232,0,36324232,2013.csv,2013,0.0,100.0
1337,A Most Wanted Man,36233517,17237855,18995662,2014.csv,2014,47.574335662751146,52.425664337248854
1338,A Very Harold & Kumar Christmas,36192775,35061031,1131744,2011.csv,2011,96.873011257081,3.126988742918994
1339,Nobunaga Concerto: The Movie,36187594,0,36187594,2016.csv,2016,0.0,100.0
1340,Dügün Dernek,36185741,0,36185741,2013.csv,2013,0.0,100.0
1341,Nothing to Lose,36075317,1016188,35059129,2018.csv,2018,2.8168512005036574,97.18314879949634
1342,T-34,35950901,0,35950901,2018.csv,2018,0.0,100.0
1343,Kundo: Age of the Rampant,35941291,280958,35660333,2014.csv,2014,0.781713711953196,99.21828628804681
1344,Ra.One,35911689,2511689,33400000,2011.csv,2011,6.994070927713815,93.0059290722862
1345,Doraemon the Movie: The New Records of Nobita's Spaceblazer 2014 Re-release,35861856,0,35861856,2014.csv,2014,0.0,100.0
1346,Conquest 1453,35797045,35730,35761315,2012.csv,2012,0.09981270800425007,99.90018729199575
1347,The New Adventures of Aladdin,35771820,0,35771820,2015.csv,2015,0.0,100.0
1348,Heidi,35755670,0,35755670,2015.csv,2015,0.0,100.0
1349,"Tad, the Lost Explorer, and the Secret of King Midas",35704046,5874,35698172,2017.csv,2017,0.016451916962016012,99.98354808303799
1350,Hostiles,35669017,29819114,5849903,2017.csv,2017,83.5994835517895,16.4005164482105
1351,The Terror Live,35659824,0,35659824,2013.csv,2013,0.0,100.0
1352,Good Deeds,35579177,35025791,553386,2012.csv,2012,98.44463518647439,1.555364813525619
1353,The Queen's Corgi,35515687,0,35515687,2019.csv,2019,0.0,100.0
1354,Mia and the White Lion,35487190,399471,35087719,2018.csv,2018,1.1256766173934876,98.8743233826065
1355,Arbitrage,35485056,7919574,27565482,2012.csv,2012,22.318054112694654,77.68194588730535
1356,Hide and Seek,35461505,0,35461505,2013.csv,2013,0.0,100.0
1357,Room,35401758,14677654,20724104,2015.csv,2015,41.46024047732319,58.53975952267682
1358,Namiya,35351623,70814,35280809,2017.csv,2017,0.20031329254670996,99.79968670745329
1359,Eye in the Sky,35259653,18704595,16555058,2016.csv,2016,53.04815393390287,46.95184606609713
1360,Les Tuche 2: The American Dream,35210425,0,35210425,2016.csv,2016,0.0,100.0
1361,Courageous,35185884,34522221,663663,2011.csv,2011,98.1138373559124,1.886162644087612
1362,Destiny: The Tale of Kamakura,35166640,0,35166640,2017.csv,2017,0.0,100.0
1363,The Girl in the Spider's Web,35164920,14841338,20323582,2018.csv,2018,42.204953118050604,57.795046881949396
1364,My Week with Marilyn,35057696,14600347,20457349,2011.csv,2011,41.64662446727817,58.35337553272183
1365,The Liquidator,35046130,0,35046130,2017.csv,2017,0.0,100.0
1366,Welcome to the North,34995189,0,34995189,2012.csv,2012,0.0,100.0
1367,Blind Detective,34958596,0,34958596,2013.csv,2013,0.0,100.0
1368,When Marnie Was There,34949567,561085,34388482,2014.csv,2014,1.6054133088401354,98.39458669115987
1369,The Sitter,34942188,30441326,4500862,2011.csv,2011,87.11911801287316,12.880881987126852
1370,The Hate U Give,34934009,29719483,5214526,2018.csv,2018,85.07321046376326,14.926789536236736
1371,Lost and Love,34930177,188817,34741360,2015.csv,2015,0.5405555202311171,99.45944447976889
1372,Secret in Their Eyes,34854990,20180155,14674835,2015.csv,2015,57.8974631752871,42.10253682471291
1373,"Dad, Where Are We Going 2",34840000,0,34840000,2015.csv,2015,0.0,100.0
1374,Chimpanzee,34823764,28972764,5851000,2012.csv,2012,83.19825507661952,16.801744923380483
1375,Kidnap,34814102,30971040,3843062,2017.csv,2017,88.96119164584513,11.038808354154876
1376,Doraemon: Nobita and the Space Heroes,34811747,0,34811747,2015.csv,2015,0.0,100.0
1377,Broken City,34737199,19701164,15036035,2013.csv,2013,56.714889418689175,43.28511058131083
1378,Endless Love,34718173,23438250,11279923,2014.csv,2014,67.51003285800782,32.489967141992175
1379,Jane Eyre,34710627,11242660,23467967,2011.csv,2011,32.38967708650149,67.6103229134985
1380,Alex Cross,34618867,25888412,8730455,2012.csv,2012,74.78122262060165,25.21877737939835
1381,R.A.I.D. Special Unit,34598750,0,34598750,2017.csv,2017,0.0,100.0
1382,Salmon Fishing in the Yemen,34564651,9047981,25516670,2012.csv,2012,26.17697774526929,73.8230222547307
1383,Haywire,34513760,18942396,15571364,2012.csv,2012,54.883605843002904,45.11639415699709
1384,Steve Jobs,34441873,17766658,16675215,2015.csv,2015,51.584471030364696,48.415528969635304
1385,Adventures in Zambezia,34428345,0,34428345,2012.csv,2012,0.0,100.0
1386,Warrior of the Hornor,34291831,0,34291831,2019.csv,2019,0.0,100.0
1387,Victor Frankenstein,34227298,5775076,28452222,2015.csv,2015,16.872719546836564,83.12728045316344
1388,The House,34184504,25584504,8600000,2017.csv,2017,74.8424022767743,25.157597723225706
1389,Cirque du Soleil: Worlds Away,34153101,12512862,21640239,2012.csv,2012,36.6375574504933,63.3624425495067
1390,The Battle: Roar to Victory,34148707,0,34148707,2019.csv,2019,0.0,100.0
1391,Black & White: The Dawn of Justice,34146896,0,34146896,2014.csv,2014,0.0,100.0
1392,The Bad Guys: The Movie,34024386,166972,33857414,2019.csv,2019,0.49074214006389416,99.50925785993611
1393,"My Love, Don't Cross That River",34012261,0,34012261,2014.csv,2014,0.0,100.0
1394,The Witness,33963557,418063,33545494,2015.csv,2015,1.2309164202088727,98.76908357979113
1395,The Good Liar,33856058,17156058,16700000,2019.csv,2019,50.67352495674482,49.326475043255186
1396,Don't Go Breaking My Heart 2,33801759,0,33801759,2014.csv,2014,0.0,100.0
1397,The Art of Racing in the Rain,33766787,26395642,7371145,2019.csv,2019,78.17042823766442,21.829571762335576
1398,I Want to Eat Your Pancreas,33748006,277019,33470987,2017.csv,2017,0.8208455338072419,99.17915446619276
1399,Nobody's Fool,33705333,31713110,1992223,2018.csv,2018,94.08929441521909,5.910705584780901
1400,The Skin I Live In,33678406,3185812,30492594,2011.csv,2011,9.459509455405936,90.54049054459406
1401,Three Heroes on Distant Shores,33674759,0,33674759,2012.csv,2012,0.0,100.0
1402,Gantz: Perfect Answer,33672515,0,33672515,2011.csv,2011,0.0,100.0
1403,Punch,33556725,0,33556725,2011.csv,2011,0.0,100.0
1404,2016: Obama's America,33449086,33449086,0,2012.csv,2012,100.0,0.0
1405,Get on Up,33448971,30703100,2745871,2014.csv,2014,91.79086555457864,8.209134445421356
1406,The Perks of Being a Wallflower,33384127,17742948,15641179,2012.csv,2012,53.14785676438386,46.85214323561613
1407,Girls,33325338,0,33325338,2014.csv,2014,0.0,100.0
1408,Perfect Strangers,33262366,1014507,32247859,2017.csv,2017,3.050014541960124,96.94998545803988
1409,Project Almanac,33213241,22348241,10865000,2015.csv,2015,67.28714310054836,32.71285689945164
1410,Bharat,33185983,2971549,30214434,2019.csv,2019,8.954229259986061,91.04577074001395
1411,Baaghi 2,33139063,1319579,31819484,2018.csv,2018,3.9819442088631174,96.01805579113687
1412,Lockout,32948113,14326864,18621249,2012.csv,2012,43.483109336185656,56.516890663814344
1413,Inside Llewyn Davis,32935319,13235319,19700000,2013.csv,2013,40.185792644060925,59.814207355939075
1414,Sleepless,32917353,20783704,12133649,2017.csv,2017,63.13905009312262,36.86094990687738
1415,Brightburn,32893421,17300439,15592982,2019.csv,2019,52.59543846169117,47.40456153830883
1416,Serial Teachers,32849727,0,32849727,2013.csv,2013,0.0,100.0
1417,Hindi Medium,32841493,0,32841493,2017.csv,2017,0.0,100.0
1418,Bait,32813407,0,32813407,2012.csv,2012,0.0,100.0
1419,The Crossing,32806475,0,32806475,2014.csv,2014,0.0,100.0
1420,Fly Me to the Saitama,32802347,0,32802347,2019.csv,2019,0.0,100.0
1421,Old Boys: The Way of the Dragon,32800000,0,32800000,2014.csv,2014,0.0,100.0
1422,Steel Rain,32783733,0,32783733,2017.csv,2017,0.0,100.0
1423,Part of Me,32726956,25326071,7400885,2012.csv,2012,77.38596586862523,22.614034131374762
1424,Mud,32613173,21590086,11023087,2013.csv,2013,66.20050738393348,33.799492616066516
1425,The Hurricane Heist,32517248,6115825,26401423,2018.csv,2018,18.80794155766195,81.19205844233804
1426,Midsummer's Equation,32514549,0,32514549,2013.csv,2013,0.0,100.0
1427,Nameless Gangster: Rules of the Time,32472645,0,32472645,2012.csv,2012,0.0,100.0
1428,UglyDolls,32450241,20150241,12300000,2019.csv,2019,62.09581309426947,37.90418690573053
1429,Movie 43,32438988,8840453,23598535,2012.csv,2012,27.25255485775327,72.74744514224673
1430,The House That Never Dies II,32433588,0,32433588,2017.csv,2017,0.0,100.0
1431,Stuber,32390945,22370452,10020493,2019.csv,2019,69.06390659488324,30.93609340511677
1432,Detective K: Secret of Virtuous Widow,32358664,0,32358664,2011.csv,2011,0.0,100.0
1433,Hit Me Anyone One More Time!,32333512,0,32333512,2019.csv,2019,0.0,100.0
1434,Kevin Hart: Let Me Explain,32318051,32244051,74000,2013.csv,2013,99.7710257960791,0.2289742039208986
1435,Pokémon,32293377,0,32293377,2013.csv,2013,0.0,100.0
1436,Seven Psychopaths,32226382,15024049,17202333,2012.csv,2012,46.62034044032619,53.37965955967381
1437,Somewhere Winter,32218990,0,32218990,2019.csv,2019,0.0,100.0
1438,The After-Dinner Mysteries,32160741,0,32160741,2013.csv,2013,0.0,100.0
1439,The Kid Who Would Be King,32140970,16790790,15350180,2019.csv,2019,52.24108046521309,47.75891953478691
1440,Two Tigers,32001580,0,32001580,2019.csv,2019,0.0,100.0
1441,Os Dez Mandamentos - O Filme,31998251,0,31998251,2016.csv,2016,0.0,100.0
1442,Dilwale,31994323,4871263,27123060,2015.csv,2015,15.225397955756087,84.7746020442439
1443,Suffragette,31972096,4702420,27269676,2015.csv,2015,14.70788777814254,85.29211222185747
1444,The Floating Castle,31967471,0,31967471,2012.csv,2012,0.0,100.0
1445,The Neighbors,31949315,0,31949315,2012.csv,2012,0.0,100.0
1446,All About Me,31920159,0,31920159,2018.csv,2018,0.0,100.0
1447,Bounty Hunters,31918573,0,31918573,2016.csv,2016,0.0,100.0
1448,Bad Times at the El Royale,31882724,17839115,14043609,2018.csv,2018,55.952292533097236,44.047707466902764
1449,Tinker Bell and the Legend of the NeverBeast,31836701,0,31836701,2014.csv,2014,0.0,100.0
1450,The Dream Team,31822402,0,31822402,2012.csv,2012,0.0,100.0
1451,Self/less,31807156,12279691,19527465,2015.csv,2015,38.60669278322148,61.39330721677852
1452,Underdogs,31775719,0,31775719,2013.csv,2013,0.0,100.0
1453,Spring Breakers,31724284,14124284,17600000,2013.csv,2013,44.52199457046848,55.47800542953152
1454,Hunter Killer,31672678,15767460,15905218,2018.csv,2018,49.782528651350546,50.217471348649454
1455,New World,31670607,457806,31212801,2013.csv,2013,1.445523289149463,98.55447671085054
1456,Ae Dil Hai Mushkil,31668920,4264983,27403937,2016.csv,2016,13.46740905594507,86.53259094405493
1457,Anna,31626978,7743794,23883184,2019.csv,2019,24.48477372703772,75.51522627296228
1458,Super Troopers 2,31626386,30617396,1008990,2018.csv,2018,96.80965760678441,3.1903423932155888
1459,The Four 3,31521335,0,31521335,2014.csv,2014,0.0,100.0
1460,Bodyguard,31516209,1834384,29681825,2011.csv,2011,5.820446234507457,94.17955376549254
1461,The Thing,31505287,16928670,14576617,2011.csv,2011,53.732790943945375,46.267209056054625
1462,I Don't Know How She Does It,31410151,9662284,21747867,2011.csv,2011,30.76166045811114,69.23833954188886
1463,Assassination Classroom: The Graduation,31352921,0,31352921,2016.csv,2016,0.0,100.0
1464,"All's Well, Ends Well 2011",31335572,0,31335572,2011.csv,2011,0.0,100.0
1465,What's in a Name?,31303580,8111,31295469,2012.csv,2012,0.025910774422605976,99.97408922557739
1466,101 Proposals,31283838,0,31283838,2013.csv,2013,0.0,100.0
1467,Tazza: The Hidden Card,31278476,251555,31026921,2014.csv,2014,0.8042431479078457,99.19575685209216
1468,Perfect Strangers,31254929,0,31254929,2016.csv,2016,0.0,100.0
1469,Saving Mr. Wu,31222161,92696,31129465,2015.csv,2015,0.29689168536412325,99.70310831463588
1470,The Invisible Guest,31191910,0,31191910,2017.csv,2017,0.0,100.0
1471,My Dear Liar,31177968,90545,31087423,2019.csv,2019,0.29041340987969455,99.7095865901203
1472,Joyful Noise,31158113,30932113,226000,2012.csv,2012,99.27466724316713,0.7253327568328672
1473,Mrs. Brown's Boys D'Movie,31116264,0,31116264,2014.csv,2014,0.0,100.0
1474,Premium Rush,31083599,20275446,10808153,2012.csv,2012,65.22875938529512,34.77124061470488
1475,The Wild Goose Lake,31064835,12573,31052262,2019.csv,2019,0.040473416324277915,99.95952658367571
1476,The Strangers: Prey at Night,31039126,24586708,6452418,2018.csv,2018,79.21198554366512,20.788014456334885
1477,Vysotsky. Thank You for Being Alive,31016553,0,31016553,2011.csv,2011,0.0,100.0
1478,This Is Not What I Expected,30996615,337670,30658945,2017.csv,2017,1.0893770174581965,98.91062298254181
1479,Silenced,30996130,0,30996130,2011.csv,2011,0.0,100.0
1480,Playing for Keeps,30962335,13103272,17859063,2012.csv,2012,42.32003820125323,57.679961798746774
1481,Rise of the Legend,30932534,0,30932534,2014.csv,2014,0.0,100.0
1482,Billy Lynn's Long Halftime Walk,30930984,1738477,29192507,2016.csv,2016,5.620503376161587,94.3794966238384
1483,Pandora,30896701,0,30896701,2016.csv,2016,0.0,100.0
1484,Gintama 2: Rules are Made to be Broken,30896653,0,30896653,2018.csv,2018,0.0,100.0
1485,African Cats,30857747,15428747,15429000,2011.csv,2011,49.9995900543225,50.000409945677504
1486,Attack on Titan Part 1,30810658,449523,30361135,2015.csv,2015,1.4589853939503663,98.54101460604964
1487,Winter's Tale,30800231,12600231,18200000,2014.csv,2014,40.90953408758525,59.09046591241475
1488,Norm of the North,30734502,17062499,13672003,2016.csv,2016,55.51578157993254,44.48421842006746
1489,Carnage,30722632,2547047,28175585,2011.csv,2011,8.290458317503527,91.70954168249648
1490,A Man Called Ove,30692889,3479315,27213574,2015.csv,2015,11.335899334858963,88.66410066514104
1491,A Wedding Invitation,30665036,14350,30650686,2013.csv,2013,0.04679596658552757,99.95320403341448
1492,When the Bough Breaks,30658387,29747603,910784,2016.csv,2016,97.02925010373181,2.970749896268189
1493,Wild Tales,30642704,3106530,27536174,2014.csv,2014,10.137910805782676,89.86208919421732
1494,The Last Warrior,30618274,0,30618274,2017.csv,2017,0.0,100.0
1495,A Dangerous Method,30519436,5704709,24814727,2011.csv,2011,18.69205250057701,81.307947499423
1496,The Four,30505808,0,30505808,2012.csv,2012,0.0,100.0
1497,What's Your Number?,30426096,14011084,16415012,2011.csv,2011,46.04956219161341,53.95043780838659
1498,S Storm,30381402,0,30381402,2016.csv,2016,0.0,100.0
1499,The Way of the Bug,30355804,0,30355804,2018.csv,2018,0.0,100.0
1500,Nocturnal Animals,30311857,10663357,19648500,2016.csv,2016,35.17883117487655,64.82116882512345
1501,Doraemon: Nobita and the New Steel Troops: ~Winged Angels~,30236973,0,30236973,2011.csv,2011,0.0,100.0
1502,Far from the Madding Crowd,30229977,12236500,17993477,2015.csv,2015,40.4780327818311,59.5219672181689
1503,Eternal Moment,30186159,0,30186159,2011.csv,2011,0.0,100.0
1504,The Grand Heist,30158762,0,30158762,2012.csv,2012,0.0,100.0
1505,A Silent Voice: The Movie,30156463,310407,29846056,2016.csv,2016,1.0293216415996798,98.97067835840032
1506,When the Game Stands Tall,30138754,30127963,10791,2014.csv,2014,99.96419560012335,0.03580439987665051
1507,The Rum Diary,30134958,13109815,17025143,2011.csv,2011,43.50367768888213,56.49632231111787
1508,Clergy,30114115,0,30114115,2018.csv,2018,0.0,100.0
1509,My Own Swordsman,30082188,0,30082188,2011.csv,2011,0.0,100.0
1510,My Hero Academia: Heroes Rising,29971229,13304000,16667229,2019.csv,2019,44.38923742499849,55.610762575001516
1511,Reset 2017 Re-release,29949252,108970,29840282,2017.csv,2017,0.36384881999724067,99.63615118000277
1512,Keeping Up with the Joneses,29918745,14904426,15014319,2016.csv,2016,49.816347577413424,50.183652422586576
1513,The Bye Bye Man,29874280,22395806,7478474,2017.csv,2017,74.96684773658143,25.033152263418568
1514,You Are the Apple of My Eye,29843025,0,29843025,2011.csv,2011,0.0,100.0
1515,Draft Day,29824199,28842237,981962,2014.csv,2014,96.70749916871195,3.2925008312880424
1516,The Disaster Artist,29820616,21120616,8700000,2017.csv,2017,70.82555236283517,29.174447637164842
1517,Ice,29806210,0,29806210,2018.csv,2018,0.0,100.0
1518,Jackie,29777777,13960394,15817383,2016.csv,2016,46.88192137378152,53.11807862621847
1519,Torrente 4,29737384,0,29737384,2011.csv,2011,0.0,100.0
1520,The Swindlers,29721916,241916,29480000,2017.csv,2017,0.8139313764294335,99.18606862357056
1521,The Raven,29699345,16008272,13691073,2012.csv,2012,53.901094451746324,46.09890554825367
1522,Masterminds,29674699,17368022,12306677,2016.csv,2016,58.52804774868988,41.471952251310114
1523,Amour,29652180,6739492,22912688,2012.csv,2012,22.72848741643953,77.27151258356047
1524,The Sorcerer and the White Snake,29649716,0,29649716,2011.csv,2011,0.0,100.0
1525,Free Solo,29390279,17541090,11849189,2018.csv,2018,59.68330549022689,40.31669450977311
1526,All About My Wife,29382038,0,29382038,2012.csv,2012,0.0,100.0
1527,Alibi.com,29370592,0,29370592,2017.csv,2017,0.0,100.0
1528,Mr. Holmes,29355203,17737646,11617557,2015.csv,2015,60.42419805443008,39.57580194556992
1529,Rowdy Rathore,29342463,777373,28565090,2012.csv,2012,2.649310659435781,97.35068934056422
1530,Sword Art Online the Movie: Ordinal Scale,29322339,1522976,27799363,2017.csv,2017,5.193910349375607,94.80608965062439
1531,Silent Witness,29315945,0,29315945,2013.csv,2013,0.0,100.0
1532,Big Eyes,29253166,14482031,14771135,2014.csv,2014,49.5058586137309,50.4941413862691
1533,Fall In Love At First Kiss,29206238,0,29206238,2019.csv,2019,0.0,100.0
1534,Dark Figure of Crime,29176133,0,29176133,2018.csv,2018,0.0,100.0
1535,Flight Crew,29171110,0,29171110,2016.csv,2016,0.0,100.0
1536,Unfair: The Answer,29166054,0,29166054,2011.csv,2011,0.0,100.0
1537,Viking,29161298,0,29161298,2016.csv,2016,0.0,100.0
1538,Dragon,29140858,0,29140858,2011.csv,2011,0.0,100.0
1539,Special ID,29139936,12666,29127270,2013.csv,2013,0.04346612154535961,99.95653387845465
1540,The Fatal Encounter,29060186,0,29060186,2014.csv,2014,0.0,100.0
1541,Pad Man,29045020,1670192,27374828,2018.csv,2018,5.750355826919726,94.24964417308027
1542,SPEC: Heaven,29023960,0,29023960,2012.csv,2012,0.0,100.0
1543,Recep Ivedik 5,28952258,0,28952258,2017.csv,2017,0.0,100.0
1544,M.S. Dhoni: The Untold Story,28903047,1801550,27101497,2016.csv,2016,6.233079854867897,93.7669201451321
1545,We Were There: True Love,28876929,0,28876929,2012.csv,2012,0.0,100.0
1546,Kokowääh 2,28811936,0,28811936,2013.csv,2013,0.0,100.0
1547,Bol Bachchan,28775262,1216258,27559004,2012.csv,2012,4.226748656536993,95.773251343463
1548,Mirai,28756961,812794,27944167,2018.csv,2018,2.826425226226095,97.17357477377391
1549,Judwaa 2,28733523,1431255,27302268,2017.csv,2017,4.981133013170713,95.01886698682928
1550,Yolki 2,28719002,0,28719002,2011.csv,2011,0.0,100.0
1551,The Suspect,28674130,218693,28455437,2013.csv,2013,0.7626839942484741,99.23731600575152
1552,The Fortress,28645448,252895,28392553,2017.csv,2017,0.8828453302598025,99.11715466974019
1553,Love & Mercy,28641776,12551031,16090745,2015.csv,2015,43.820714888629816,56.17928511137019
1554,Maya the Bee Movie,28638603,0,28638603,2014.csv,2014,0.0,100.0
1555,The Four 2,28599970,0,28599970,2013.csv,2013,0.0,100.0
1556,Pokémon the Movie: Diancie and the Cocoon of Destruction,28595105,0,28595105,2014.csv,2014,0.0,100.0
1557,Flying Colors,28525563,0,28525563,2015.csv,2015,0.0,100.0
1558,Deranged,28444173,0,28444173,2012.csv,2012,0.0,100.0
1559,The Kiyosu Conference,28338665,0,28338665,2013.csv,2013,0.0,100.0
1560,I Give It a Year,28328531,34657,28293874,2013.csv,2013,0.12233955936507969,99.87766044063491
1561,Gully Boy,28299498,5566534,22732964,2019.csv,2019,19.670080366796615,80.32991963320339
1562,The Master,28258060,16377274,11880786,2012.csv,2012,57.956115883397516,42.043884116602484
1563,Fan,28240000,2300000,25940000,2016.csv,2016,8.144475920679886,91.85552407932012
1564,"Yôkai Watch: the Movie: The Flying Whale and the Grand Adventure of the Double Worlds, Meow!",28110245,0,28110245,2016.csv,2016,0.0,100.0
1565,Triumph in the Skies,28085162,0,28085162,2015.csv,2015,0.0,100.0
1566,Welcome to Germany,28036021,0,28036021,2016.csv,2016,0.0,100.0
1567,Your Highness,28013733,21596445,6417288,2011.csv,2011,77.09234967007075,22.907650329929254
1568,Mandela: Long Walk to Freedom,27985788,8323085,19662703,2013.csv,2013,29.740398948208995,70.259601051791
1569,The Brothers Grimsby,27979040,6874837,21104203,2016.csv,2016,24.571382720779557,75.42861727922045
1570,What Happened to Monday,27975429,0,27975429,2017.csv,2017,0.0,100.0
1571,The 33,27972023,12227722,15744301,2015.csv,2015,43.71411392018375,56.28588607981625
1572,The Divine Move,27926871,136707,27790164,2014.csv,2014,0.48951778378608907,99.51048221621392
1573,Monster Family,27890108,127259,27762849,2017.csv,2017,0.4562872255639885,99.54371277443602
1574,The Beguiled,27869129,10709995,17159134,2017.csv,2017,38.42960072415611,61.57039927584389
1575,When Larry Meets Mary,27863090,0,27863090,2016.csv,2016,0.0,100.0
1576,Dark Skies,27858103,17418667,10439436,2013.csv,2013,62.526393128778366,37.473606871221634
1577,Love Strikes!,27707149,0,27707149,2011.csv,2011,0.0,100.0
1578,Kim Ji-young: Born 1982,27696393,0,27696393,2019.csv,2019,0.0,100.0
1579,Default,27694043,203775,27490268,2018.csv,2018,0.7358080580722721,99.26419194192772
1580,Nebraska,27682872,17654912,10027960,2013.csv,2013,63.77557935462765,36.22442064537235
1581,Bride Wars,27670000,0,27670000,2015.csv,2015,0.0,100.0
1582,One Cut of the Dead,27590180,52406,27537774,2018.csv,2018,0.18994439325876092,99.81005560674124
1583,Nicholas on Holiday,27567832,0,27567832,2014.csv,2014,0.0,100.0
1584,The Women on the 6th Floor,27533970,719823,26814147,2011.csv,2011,2.6143087974600103,97.38569120253999
1585,Grace of Monaco,27515247,0,27515247,2014.csv,2014,0.0,100.0
1586,The Happytime Murders,27506452,20706452,6800000,2018.csv,2018,75.27852737968533,24.72147262031468
1587,The Incredible Burt Wonderstone,27437881,22537881,4900000,2013.csv,2013,82.14147805364416,17.858521946355843
1588,Yesterday Once More,27411872,0,27411872,2016.csv,2016,0.0,100.0
1589,Left Behind,27405896,14019924,13385972,2014.csv,2014,51.15659783573578,48.84340216426422
1590,Irrational Man,27391084,4030360,23360724,2015.csv,2015,14.714131065422603,85.28586893457741
1591,Detective K: Secret of the Lost Island,27387870,185367,27202503,2015.csv,2015,0.6768215271943382,99.32317847280567
1592,Gorko!,27369902,0,27369902,2013.csv,2013,0.0,100.0
1593,Midnight Sun,27365467,9561064,17804403,2018.csv,2018,34.93842805606058,65.06157194393943
1594,Pokémon: Mewtwo Strikes Back - Evolution,27347118,0,27347118,2019.csv,2019,0.0,100.0
1595,To the Fore,27267799,0,27267799,2015.csv,2015,0.0,100.0
1596,American Ultra,27262374,14440985,12821389,2015.csv,2015,52.970386951627916,47.029613048372084
1597,VIP Policeman,27222681,0,27222681,2018.csv,2018,0.0,100.0
1598,Khumba,27187375,1029,27186346,2013.csv,2013,0.0037848449877930478,99.99621515501221
1599,Joy of Fatherhood,27088817,0,27088817,2014.csv,2014,0.0,100.0
1600,My Neighbor Totoro 2018 Re-release,27083857,1144649,25939208,2018.csv,2018,4.2263145902742,95.7736854097258
1601,Hitchcock,27039669,6008677,21030992,2012.csv,2012,22.221710628188532,77.77828937181147
1602,Almost a Comedy,26990962,0,26990962,2019.csv,2019,0.0,100.0
1603,Letters to Santa,26923513,0,26923513,2011.csv,2011,0.0,100.0
1604,Total Dhamaal,26911995,2167632,24744363,2019.csv,2019,8.05451992689505,91.94548007310495
1605,You're Next,26895481,18494006,8401475,2013.csv,2013,68.76250326216513,31.23749673783488
1606,Mr. Go,26835201,0,26835201,2013.csv,2013,0.0,100.0
1607,CHIPS,26800152,18600152,8200000,2017.csv,2017,69.40315860895117,30.59684139104883
1608,The Faces of My Gene,26796279,0,26796279,2018.csv,2018,0.0,100.0
1609,Dearest,26723916,0,26723916,2012.csv,2012,0.0,100.0
1610,Architecture 101,26642354,0,26642354,2012.csv,2012,0.0,100.0
1611,A Cure for Wellness,26620002,8106986,18513016,2017.csv,2017,30.45449057441844,69.54550942558157
1612,A Monster in Paris,26611650,0,26611650,2011.csv,2011,0.0,100.0
1613,Missing Link,26565710,16649539,9916171,2019.csv,2019,62.67304355878311,37.32695644121689
1614,No Manches Frida 2,26493648,9270920,17222728,2019.csv,2019,34.99299152762957,65.00700847237043
1615,A Hard Day,26488847,19004,26469843,2014.csv,2014,0.07174340204388661,99.9282565979561
1616,The Break Up Man,26477012,0,26477012,2013.csv,2013,0.0,100.0
1617,The Way Way Back,26474920,21506546,4968374,2013.csv,2013,81.23365811870254,18.766341881297468
1618,We Are the Nobles,26433651,0,26433651,2013.csv,2013,0.0,100.0
1619,Ivan Tsarevich & the Grey Wolf,26420475,0,26420475,2011.csv,2011,0.0,100.0
1620,Dancing Queen,26411266,0,26411266,2012.csv,2012,0.0,100.0
1621,Only the Brave,26351322,18343983,8007339,2017.csv,2017,69.61314123063731,30.38685876936269
1622,Twenty Two,26289378,46796,26242582,2017.csv,2017,0.17800345067121784,99.82199654932879
1623,Orange,26261536,0,26261536,2015.csv,2015,0.0,100.0
1624,Aloha,26250020,21067116,5182904,2015.csv,2015,80.25561885286182,19.744381147138174
1625,The Stolen Years,26249553,0,26249553,2013.csv,2013,0.0,100.0
1626,Apollo 18,26236153,17687709,8548444,2011.csv,2011,67.41731152429246,32.58268847570755
1627,The Confidence Man JP,26228317,0,26228317,2019.csv,2019,0.0,100.0
1628,One Night Surprise,26220159,0,26220159,2013.csv,2013,0.0,100.0
1629,Lesson of the Evil,26167224,0,26167224,2012.csv,2012,0.0,100.0
1630,The Zookeeper's Wife,26152835,17571660,8581175,2017.csv,2017,67.18835644395722,32.811643556042775
1631,Badrinath Ki Dulhania,26134309,1993259,24141050,2017.csv,2017,7.6269818344919695,92.37301816550803
1632,Badhaai Ho,26125610,0,26125610,2018.csv,2018,0.0,100.0
1633,Top Five,26117471,25317471,800000,2014.csv,2014,96.93691628871723,3.0630837112827654
1634,Hichki,26055222,330279,25724943,2018.csv,2018,1.2676115367583511,98.73238846324165
1635,Platinum Data,26052718,0,26052718,2013.csv,2013,0.0,100.0
1636,Iceman,26033917,7679,26026238,2014.csv,2014,0.02949613767302093,99.97050386232698
1637,Agneepath,26001696,1986748,24014948,2012.csv,2012,7.640840043664844,92.35915995633516
1638,The Light Between Oceans,25975621,12545979,13429642,2016.csv,2016,48.299053177592945,51.700946822407055
1639,A Chinese Odyssey: Part 2 - Cinderella 2017 Re-release,25960664,0,25960664,2017.csv,2017,0.0,100.0
1640,Love Off the Cuff,25959989,0,25959989,2017.csv,2017,0.0,100.0
1641,The Confidence Man JP: The Movie,25958189,0,25958189,2019.csv,2019,0.0,100.0
1642,White Boy Rick,25957482,24011188,1946294,2018.csv,2018,92.5019922964793,7.498007703520704
1643,Meet Miss Anxiety,25948636,0,25948636,2014.csv,2014,0.0,100.0
1644,"Paul, Apostle of Christ",25915966,17560475,8355491,2018.csv,2018,67.75929170458087,32.240708295419125
1645,Huevos: Little Rooster's Egg-cellent Adventure,25892561,9080818,16811743,2015.csv,2015,35.07114649647827,64.92885350352172
1646,Gekijouban SPEC: Kurôzu - Zen no hen,25860404,0,25860404,2013.csv,2013,0.0,100.0
1647,Dügün Dernek 2: Sünnet,25836668,0,25836668,2015.csv,2015,0.0,100.0
1648,Unbeatable,25816154,0,25816154,2013.csv,2013,0.0,100.0
1649,Rust and Bone,25807712,2062027,23745685,2012.csv,2012,7.989964395138942,92.01003560486106
1650,Our Idiot Brother,25804448,24816118,988330,2011.csv,2011,96.16992388289026,3.8300761171097326
1651,"The Gangster, the Cop, the Devil",25775371,216494,25558877,2019.csv,2019,0.8399258346271717,99.16007416537282
1652,Man on the Edge,25774679,0,25774679,2013.csv,2013,0.0,100.0
1653,A Beautiful Planet,25730120,15650615,10079505,2016.csv,2016,60.82604744944835,39.17395255055165
1654,Champions,25703987,0,25703987,2018.csv,2018,0.0,100.0
1655,Fireworks,25672406,525280,25147126,2017.csv,2017,2.0460879280266915,97.9539120719733
1656,Father Figures,25601244,17501244,8100000,2017.csv,2017,68.36091246191005,31.639087538089942
1657,"Love, Rosie",25574387,20431,25553956,2014.csv,2014,0.07988852284123173,99.92011147715877
1658,Mr. Donkey,25537759,356255,25181504,2016.csv,2016,1.3950127730471573,98.60498722695284
1659,Look Who's Back,25513752,0,25513752,2015.csv,2015,0.0,100.0
1660,Money,25403753,0,25403753,2017.csv,2017,0.0,100.0
1661,Head Over Heels 2,25402893,0,25402893,2012.csv,2012,0.0,100.0
1662,Keys To The Heart,25375866,75134,25300732,2018.csv,2018,0.29608447648643793,99.70391552351356
1663,Serial Teachers 2,25364150,0,25364150,2015.csv,2015,0.0,100.0
1664,A Haunted House 2,25358716,17329486,8029230,2014.csv,2014,68.33739531607199,31.662604683928002
1665,And So It Goes,25312387,15160801,10151586,2014.csv,2014,59.89478985130877,40.105210148691235
1666,Bodies at Rest,25293853,0,25293853,2019.csv,2019,0.0,100.0
1667,Enough Said,25288872,17550872,7738000,2013.csv,2013,69.40156128751018,30.598438712489827
1668,On the Other Side of the Tracks,25109572,9572,25100000,2012.csv,2012,0.03812092057961004,99.96187907942038
1669,Born in China,25081168,13873211,11207957,2016.csv,2016,55.31325734112542,44.68674265887458
1670,Race,25070261,19206207,5864054,2016.csv,2016,76.60952153629353,23.39047846370646
1671,Herutâ sukerutâ,25066699,0,25066699,2012.csv,2012,0.0,100.0
1672,The Last Exorcism Part II,25051865,15179302,9872563,2013.csv,2013,60.591504864009124,39.408495135990876
1673,Call of Heroes,25040561,0,25040561,2016.csv,2016,0.0,100.0
1674,Free State of Jones,25035950,20810036,4225914,2016.csv,2016,83.12061655339622,16.879383446603786
1675,The Last Tycoon,25009914,0,25009914,2012.csv,2012,0.0,100.0
1676,"Me, Myself and Mum",24991467,0,24991467,2013.csv,2013,0.0,100.0
1677,Whiskey Tango Foxtrot,24972139,23083334,1888805,2016.csv,2016,92.4363507667485,7.563649233251504
1678,Booksmart,24959607,22680962,2278645,2019.csv,2019,90.87066955821861,9.129330441781395
1679,Housefull 2,24922847,1791780,23131067,2012.csv,2012,7.189307064317331,92.81069293568267
1680,Wild City,24817852,34866,24782986,2015.csv,2015,0.14048758127818636,99.85951241872182
1681,Eyyvah Eyvah 2,24792348,0,24792348,2011.csv,2011,0.0,100.0
1682,Big Miracle,24719215,20157300,4561915,2012.csv,2012,81.5450652458017,18.4549347541983
1683,Super 30,24701637,2269878,22431759,2019.csv,2019,9.189180457959123,90.81081954204087
1684,Soulmate,24684439,0,24684439,2016.csv,2016,0.0,100.0
1685,Drug War,24676341,128195,24548146,2013.csv,2013,0.5195057079167451,99.48049429208325
1686,Ready,24663361,955148,23708213,2011.csv,2011,3.872740621199195,96.1272593788008
1687,The Death of Stalin,24646055,8047856,16598199,2017.csv,2017,32.65372896392547,67.34627103607454
1688,The Snow Queen 3: Fire and Ice,24644317,0,24644317,2016.csv,2016,0.0,100.0
1689,Sparkle,24637800,24397469,240331,2012.csv,2012,99.02454358749564,0.9754564125043632
1690,The Players,24629152,10854,24618298,2012.csv,2012,0.044069726801799755,99.9559302731982
1691,Liar Game: Reborn,24549726,0,24549726,2012.csv,2012,0.0,100.0
1692,God's Not Dead 2,24487848,20774575,3713273,2016.csv,2016,84.83626245964938,15.163737540350628
1693,Skyfire,24444590,1105,24443485,2019.csv,2019,0.004520427628362758,99.99547957237164
1694,The Tale of The Princess Kaguya,24434485,703232,23731253,2013.csv,2013,2.8780307831329366,97.12196921686707
1695,The 8-Year Engagement,24425963,0,24425963,2017.csv,2017,0.0,100.0
1696,Stan & Ollie,24420923,5470235,18950688,2018.csv,2018,22.399788083357866,77.60021191664214
1697,The Witch: Part 1 - The Subversion,24340302,0,24340302,2018.csv,2018,0.0,100.0
1698,The Great Beauty,24271739,2852400,21419339,2013.csv,2013,11.751939158541544,88.24806084145845
1699,Trance,24261569,2328743,21932826,2013.csv,2013,9.598484747626998,90.401515252373
1700,The Accidental Detective 2: In Action,24243825,179045,24064780,2018.csv,2018,0.7385179525095565,99.26148204749045
1701,Camping 3,24224579,0,24224579,2016.csv,2016,0.0,100.0
1702,Jolly LLB 2,24214186,1654254,22559932,2017.csv,2017,6.831755566757438,93.16824443324256
1703,The Railway Man,24174885,4438438,19736447,2013.csv,2013,18.359706778336278,81.64029322166371
1704,The Founder,24121245,12786053,11335192,2016.csv,2016,53.00743390318369,46.99256609681631
1705,Out of Inferno,24109886,0,24109886,2013.csv,2013,0.0,100.0
1706,Start-Up,24106579,0,24106579,2019.csv,2019,0.0,100.0
1707,Bad Santa 2,24079268,17782178,6297090,2016.csv,2016,73.84849904905747,26.15150095094253
1708,Kung Fu Jungle,24070765,129784,23940981,2014.csv,2014,0.5391768811668428,99.46082311883315
1709,I Can Speak,24024444,63239,23961205,2017.csv,2017,0.2632277358843351,99.73677226411567
1710,Bring Happiness Home,23980000,0,23980000,2013.csv,2013,0.0,100.0
1711,I Want You,23961214,0,23961214,2012.csv,2012,0.0,100.0
1712,Türkisch für Anfänger,23952712,0,23952712,2012.csv,2012,0.0,100.0
1713,Killing for the Prosecution,23929620,0,23929620,2018.csv,2018,0.0,100.0
1714,Pinocchio,23889592,1831718,22057874,2019.csv,2019,7.667431072075237,92.33256892792477
1715,Spirits' Homecoming,23857217,125616,23731601,2016.csv,2016,0.5265324953870353,99.47346750461297
1716,Silence,23834809,7100177,16734632,2016.csv,2016,29.78910802264033,70.21089197735967
1717,Wanderlust,23812816,17450535,6362281,2012.csv,2012,73.28211413551425,26.717885864485748
1718,"Little Brother, Big Trouble: A Christmas Adventure",23785681,0,23785681,2012.csv,2012,0.0,100.0
1719,Pokémon the Movie: The Power of Us,23740788,789170,22951618,2018.csv,2018,3.3241103875743296,96.67588961242566
1720,The Peanut Butter Falcon,23712090,20457151,3254939,2019.csv,2019,86.2730826342174,13.726917365782604
1721,To the Arctic 3D,23695388,14560838,9134550,2012.csv,2012,61.450093157368855,38.549906842631145
1722,Little White Lies 2,23623665,0,23623665,2019.csv,2019,0.0,100.0
1723,Kevin Hart: What Now?,23591043,23591043,0,2016.csv,2016,100.0,0.0
1724,No manches Frida,23540937,11528613,12012324,2016.csv,2016,48.972617360133114,51.02738263986688
1725,Wish Upon,23468586,14301505,9167081,2017.csv,2017,60.938929171105585,39.06107082889442
1726,Ossan's Love: Love or Dead,23422744,0,23422744,2019.csv,2019,0.0,100.0
1727,Only Cloud Knows,23410836,0,23410836,2019.csv,2019,0.0,100.0
1728,In His Chart,23384864,0,23384864,2011.csv,2011,0.0,100.0
1729,Detroit,23355100,16790139,6564961,2017.csv,2017,71.89067484189748,28.10932515810251
1730,Middle School: The Worst Years of My Life,23316139,20007149,3308990,2016.csv,2016,85.80815631610362,14.191843683896376
1731,Warrior,23308615,13657115,9651500,2011.csv,2011,58.592563307601075,41.407436692398925
1732,Triple 9,23177948,12639297,10538651,2016.csv,2016,54.53156163781194,45.46843836218806
1733,Hoodwinked Too! Hood vs. Evil,23167844,10143779,13024065,2011.csv,2011,43.78387130023838,56.21612869976161
1734,Rock Dog,23157646,9420546,13737100,2016.csv,2016,40.68006739545116,59.31993260454884
1735,The Guernsey Literary and Potato Peel Pie Society,23148937,0,23148937,2018.csv,2018,0.0,100.0
1736,The Crimes That Bind,23144130,0,23144130,2018.csv,2018,0.0,100.0
1737,New Happy Dad and Son 3: Adventure in Russia,23130469,0,23130469,2018.csv,2018,0.0,100.0
1738,Dark Waters,23108017,11136084,11971933,2019.csv,2019,48.19143070562914,51.80856929437086
1739,The Farewell,23076657,17695781,5380876,2019.csv,2019,76.68260181706562,23.317398182934383
1740,The Choice,23064015,18730891,4333124,2016.csv,2016,81.21262061267304,18.78737938732697
1741,Padmaavat,22991060,11846060,11145000,2018.csv,2018,51.524636097683185,48.475363902316815
1742,Hotaru the Movie: It's Only a Little Light in My Life,22975341,0,22975341,2012.csv,2012,0.0,100.0
1743,Penny Pincher!,22955486,0,22955486,2016.csv,2016,0.0,100.0
1744,Young Adult,22939027,16311571,6627456,2011.csv,2011,71.10838223434673,28.891617765653265
1745,Andalucia: Revenge of the Goddess,22929221,0,22929221,2011.csv,2011,0.0,100.0
1746,A Separation,22926076,7099055,15827021,2011.csv,2011,30.964980662194435,69.03501933780556
1747,Hot Road,22916313,0,22916313,2014.csv,2014,0.0,100.0
1748,Baggage Claim,22871096,21569509,1301587,2013.csv,2013,94.30903092707057,5.69096907292943
1749,Qualunquemente,22862029,0,22862029,2011.csv,2011,0.0,100.0
1750,Won't You Be My Neighbor?,22844741,22835787,8954,2018.csv,2018,99.96080498351897,0.03919501648103605
1751,Kon-Tiki,22842887,1517410,21325477,2012.csv,2012,6.642811830220935,93.35718816977906
1752,The Knight of Shadows: Between Yin and Yang,22774256,0,22774256,2019.csv,2019,0.0,100.0
1753,Extraordinary Mission,22757764,54174,22703590,2017.csv,2017,0.23804623336457836,99.76195376663543
1754,Black and Blue,22741061,22055313,685748,2019.csv,2019,96.98453823240702,3.01546176759299
1755,Fading Gigolo,22706304,3769873,18936431,2014.csv,2014,16.60275930420028,83.39724069579972
1756,Fall in Love Like a Star,22640355,0,22640355,2012.csv,2012,0.0,100.0
1757,Friends: Naki on the Monster Island,22537428,0,22537428,2011.csv,2011,0.0,100.0
1758,Europe Raiders,22435156,0,22435156,2018.csv,2018,0.0,100.0
1759,Late Night,22386555,15499454,6887101,2019.csv,2019,69.23554785450463,30.764452145495362
1760,Mojin: The Worm Valley,22381583,101516,22280067,2018.csv,2018,0.4535693476194244,99.54643065238058
1761,Les Misérables,22342519,330181,22012338,2019.csv,2019,1.477814565134755,98.52218543486525
1762,Kamen Rider OOO Wonderful: The Shogun and the 21 Core Medals,22313925,0,22313925,2011.csv,2011,0.0,100.0
1763,Gooische vrouwen,22194574,0,22194574,2011.csv,2011,0.0,100.0
1764,Upside Down,22187813,105095,22082718,2012.csv,2012,0.4736609236791386,99.52633907632085
1765,Unbowed,22132903,0,22132903,2012.csv,2012,0.0,100.0
1766,The Glass Castle,22088533,17273059,4815474,2017.csv,2017,78.19921313923382,21.800786860766173
1767,Stree,22075730,0,22075730,2018.csv,2018,0.0,100.0
1768,A Rainy Day in New York,22002504,0,22002504,2019.csv,2019,0.0,100.0
1769,Leap! 2017 Re-release,21929861,21858070,71791,2017.csv,2017,99.67263358395203,0.32736641604796307
1770,The Immature,21858834,0,21858834,2011.csv,2011,0.0,100.0
1771,Pleasant Goat and Big Big Wolf 3,21847806,0,21847806,2011.csv,2011,0.0,100.0
1772,Confession of Murder,21701525,0,21701525,2012.csv,2012,0.0,100.0
1773,StreetDance 2 2012 Re-release,21638853,0,21638853,2012.csv,2012,0.0,100.0
1774,Épouse-moi mon pote,21571464,0,21571464,2017.csv,2017,0.0,100.0
1775,Quick,21561934,0,21561934,2011.csv,2011,0.0,100.0
1776,2012 2012 Re-release,21538353,0,21538353,2012.csv,2012,0.0,100.0
1777,K-On! The Movie,21434003,0,21434003,2011.csv,2011,0.0,100.0
1778,Crazy Romance,21386368,0,21386368,2019.csv,2019,0.0,100.0
1779,Shaft,21360215,21360215,0,2019.csv,2019,100.0,0.0
1780,Unplanned,21354152,19005109,2349043,2019.csv,2019,88.99959595679566,11.00040404320434
1781,Hotel Mumbai,21314816,9651611,11663205,2019.csv,2019,45.28123067072219,54.71876932927782
1782,Integrity,21290004,0,21290004,2019.csv,2019,0.0,100.0
1783,The Prison,21205329,207481,20997848,2017.csv,2017,0.9784380143312088,99.0215619856688
1784,Red Dog,21185162,0,21185162,2011.csv,2011,0.0,100.0
1785,Beasts of the Southern Wild,21107746,12795746,8312000,2012.csv,2012,60.62109142302546,39.37890857697454
1786,The Secret Mission,21083522,0,21083522,2019.csv,2019,0.0,100.0
1787,Vicky and the Treasure of the Gods,20796153,0,20796153,2011.csv,2011,0.0,100.0
1788,The Front Line,20629645,11018,20618627,2011.csv,2011,0.05340857780150846,99.9465914221985
1789,Polisse,20590872,211440,20379432,2011.csv,2011,1.0268627768653993,98.9731372231346
1790,Hollywoo,20587850,0,20587850,2011.csv,2011,0.0,100.0
1791,One Hundred Thousand Bad Jokes 2,20460352,0,20460352,2017.csv,2017,0.0,100.0
1792,Scabbard Samurai,20251745,0,20251745,2011.csv,2011,0.0,100.0
1793,This Is Tomas,20084169,0,20084169,2019.csv,2019,0.0,100.0
1794,Kaiji 2: The Ultimate Gambler,19971259,0,19971259,2011.csv,2011,0.0,100.0
1795,The Specials,19363826,0,19363826,2019.csv,2019,0.0,100.0
1796,Always Miss You,19015465,91884,18923581,2019.csv,2019,0.48320669518205317,99.51679330481795
1797,An Officer and a Spy,18878658,0,18878658,2019.csv,2019,0.0,100.0
1798,Crayon Shin-chan: Honeymoon Hurricane - The Lost Hiroshi,18738951,0,18738951,2019.csv,2019,0.0,100.0
1799,Greta,18653107,10532219,8120888,2019.csv,2019,56.463617562478994,43.536382437521
1800,Peppa Celebrates Chinese New Year,18653040,131225,18521815,2019.csv,2019,0.7035046298083315,99.29649537019168
